,	，
.	。
/	／
;	；
:	：
?	？
!	！
~	～
"	“”
'	‘’
\	、
<	《
>	》
(	（
)	）
[	［
]	］
a	安
a,	媪
a,r	嫒
ab	艾
abp	蔼
ac	澳
ad	胺
adk	腌
ady	肮
af	俺
afh	傲
ag	凹
agg	盎
agk	岸
agy	黯
ah	熬
ah/	骜
ahf	鏊
ahg	螯
ahj	聱
ahk	獒
ahp	遨
ahq	敖
ahr	瑷
aht	鳌
aj	鞍
ak	碍
akb	砹
akt	鹌
al	啊
al.	唉
alb	哎
alh	嗷
ali	吖
alik	嗌
alk	嗄
alkg	嚣
alp	霭
alr	嗳
alx	呆
alz	呵
am	阿
ami	隘
ao	案
aow	懊
ap	袄
apy	谙
aq	矮
aqg	岙
aqo	氨
ar	爱
as	暗
asr	暧
ast	昂
at	犴
au	按
au.	挨
au/	拗
auk	捱
auy	揞
av	埃
av/	坳
avk	埯
aw	奥
aw.	翱
awg	皑
ax	桉
ay	哀
ayf	鏖
ayh	廒
ayk	庵
ayl	癌
az	锕
azo	铵
azy	锿
b	不
b,	边
b,;	妣
b,h	婊
b,o	办
b,w	婢
b.	弁
b.g	畚
b/	编
b/d	绷
b/f	缏
b/h	绑
b/i	绊
b/j	骠
b/o	缤
b/r	驳
b;	比
b;j	毕
b;k	毙
b;p	匾
b;pi	毖
ba	北
ba;	辈
baa	步
bad	背
bae	彪
bam	邶
bap	悲
bat	龅
bb	蔽
bb;	荜
bbc	薄
bbc,	菠
bbf	蓓
bbfl	葆
bbj	苯
bbjp	荸
bbk	茇
bbm	芭
bbn	薜
bbr	蕃
bbt	苞
bbu	菝
bbw	萆
bbw,	蓖
bby	蒡
bbyf	苄
bc	波
bca	濒
bcj	渤
bcl	灞
bco	滨
bcp	泌
bcq	滗
bcs	瀑
bcw	泊
bcwj	浜
bcwn	濞
bcy	汴
bd	脖
bdj	膊
bdjm	膘
bdo	膑
bdt	胞
bdy	膀
be	般
be,	彼
be;	舭
bee	舨
bew	舶
bf	卜
bfi	伴
bfir	煲
bfj	便
bfk	佰
bfl	保
bfla	蹩
bfo	傧
bfv	堡
bfw	伯
bfwn	俾
bfy	傍
bfyi	倍
bg	败
bgd	崩
bgf	贝
bgh	蚌
bgk	畀
bgk,	豳
bgm	岜
bgo	髌
bgp	蝙
bgr	贬
bgv	罢
bgw	髀
bh	表
bh,	玻
bhg	帮
bhi	班
bhk	碧
bhm	邦
bhm;	耙
bhr	玢
bhy	斑
bi	并
bih	半
bij	炳
bik	弊
bim	粑
bip	憋
bipk	煸
bipv	迸
biq	敝
bis	爆
bit	鳖
bitn	炮
biy	焙
bj	本
bj,	勃
bj,v	丙
bj;	甏
bje	髟
bjf	鞭
bjg	贲
bjj	博
bjja	鞴
bjm	邴
bjm;	靶
bjmz	孛
bjo	鬓
bjp	逋
bjs	醭
bjt	鹁
bk	百
bk,	夯
bkb	礴
bkg	布
bkgr	泵
bkj	奔
bko	殡
bkp	碥
bkr	砭
bkt	飙
bkth	甭
bkw	碑
bky	磅
bkyi	碚
bl	别
bl,	跛
bl;	吡
bl;t	哔跸
blc	啵
blf	卟
blg	蹦
blgf	呗
blgx	嘣
blj	霸
bljn	哺
blk	跋
blm	鄙
blm;	吧
blr	叭
blt	雹
bltv	趵
bly	踣
bm	巴
bm,	陂
bm;	陛
bme	阪
bmt	孢
bn	辟
bn,	嬖
bnd	臂
bnf	鐾
bnh	璧
bni	屏
bnk	弼
bnp	避
bnq	擘
bns	剥
bnv	壁
bnx	檗
bny	襞
bo	宝
boj	悖
bok	怖
boq	愎
bor	窆
bow	宾
boy	忭
bp	被
bpa	褙
bpf	补
bpfl	褓
bpg	扁
bph	裱
bpi	必
bpp	遍
bppk	褊
bpw	裨
bpy	谤
bq	笔
bq,	笾
bq;	秕
bq;t	筚
bqc	簿
bqcw	箔
bqg	箅
bqh	拜
bqj	笨
bqja	簸
bqm	笆
bqn	秉
bqp	秘
bqr	掰
bqw	稗
bqw,	篦
br	八
brk	颁
brm	爸
brt	豹
brv	坌
bs	暴
bsj	晡
bss	曝
bt	匕
bt;	狴
btg	备
btgf	狈
bti	饼
btii	飚
btj	饽
btjm	鳔
btk	鲅
btn	包
btp	惫
btpk	鳊
bts	刨
btt	饱
bttn	鲍飑
bttp	鸨
bu	把
bu,	拨
bue	搬
bue.	扳
bug	摆
bui	拌
buj	捕
buj,	抦
bujc	闭
bujn	搏
buk	拔
bul	捌
bum	报
bun	摒
buo	摈
bur	扒
bur,	扮
burq	播
but	抱
buw	捭
bv	坝
bve	坂
bvj	埔
bvw	埠
bw	白
bwe	版
bwg	鼻
bwgx	帛
bwj	卑
bwk	魃
bwm	币
bwr	兵
bwt	鹎
bww	魄
bx	标
bxe	板
bxec	彬
bxh	棒
bxhk	梆
bxj	柄
bxk	杯
bxo	槟
bxt	杓
bxw	柏
bxy	榜
by	部
by.	变
by/	辫
by;	庇
by;.	瓿
bye	瓣
bye.	瘢
byf	卞
byfl	褒
byg	冰
bygj	痹
bygl	禀
byh	斌
byha	癍
byi	辨
byj	病
byjm	瘭
bym	疤
byp	辩
byq	亳
byw	瘪
bywn	庳
bz	逼
bze	钣
bzg	钡
bzj	钵
bzjm	镖
bzk	钚
bzk.	钹
bzkg	钸
bzky	锛
bzm	钯
bzo	镔
bzp	铋
bzw	铂
bzy	镑
bzyt	镳
c	成
c,	娼
c,f	嫦
c,i	婵
c,m	媸
c,o	姹
c.	参
c.,	皴
c.;	戳
c.g	翀
c.v	叉
c.y	翠
c/	纯
c/.	骖
c/a	绰
c/b	巛
c/g	巢
c/gj	骋
c/m	驰
c/mg	绌
c/n	骣
c/s	剿
c/t	绸
c/w	骢
c/y	缠
c;	车
c;.	辍
c;g	臣
c;gj	虿
c;h	辏
ca	此
caf	餐
cafm	齿
cafy	雌
cag	觇
cai	粲
caih	鹾
cal	龊
cat	龀
cax	柴
cb	草
cb/	莼
cba	茈
cbf	茶
cbf/	苍
cbff	苁
cbfj	茌
cbk	藏
cbkg	蒇
cbkx	茬
cbq	苌
cbr	菜
cbs	菖
cbt	蔡
cbte	葱
cby	茨
cby,	蔟
cby.	茺
cbyf	萃
cc	测
cc.	澄
cc.v	汊
ccf	沧
ccg	涔
ccj	潮
ccjn	漕
ccm	池
ccmf	滁
ccn	潺
cco	淙
ccp	沉
ccy	淳
ccy.	澈
ccyf	淬
ccyg	澶
cd	尘
cd,	肠
cd;	肫
cdf	脞
cdh	腠
cdi	塍
cdt	脆
cdy	膪
ce	惩
ce;	彻
cef	舱
cefw	徜
ceg	徂
cej	斥
cejn	艚
cejz	舡
cet	船
cex	彳
cey	艟
cf	从
cf,	仇
cf/	仓
cff	偿
cff/	伧
cffw	倘
cfg	侧
cfgx	催
cfh	传
cfh.	尝
cfhk	俦
cfl	常
cfla	促
cfly	裳
cfn	伺
cfp	储
cfpf	雠
cfq	敞
cfq.	伥
cfq;	氅
cfs	创
cfss	倡
cft	侈
cfto	傺
cfy	侪
cfyh	隹
cfz	丛
cg	财
cg,	畅
cg.	蛏
cg.k	黪
cgf	崔
cgfh	蜍
cgfp	岑
cgfr	瞠
cgh	畴
cghk	蝽
cgi	蝉
cgih	嵯
cgj	串
cgjn	螬
cgjz	虫
cgm	黜
cgo	崇
cgp	遄
cgq	瞅
cgr	睬
cgs	赐
cgt	眵
cgtk	蟾
cgy	螭
cgyi	幢
ch	春
cha	璨
chd	耖
chg	蠢
chgj	蚕
chgx	璀
cho	琮
chp	琛
chw	舂
chw,	璁
chx	亍
ci	差
ci/	兹
cia	焯
cid	炒
cig	粗
cigj	单
cigx	灿
cii	糍
cil	炽
cin	冁
cip	慈
ciq	糙
cis	曾
cit	炊
citp	鹚
ciy	粹
cj	才
cj.	翅
cja	耻
cjd	朝
cji	酬
cjil	聪
cjj	醋
cjjg	矗
cjl	酲
cjq	敕
cjqa	酢
cjs	刺曹
cjv	寸
cjy	醇
cjyt	裁
ck	厂
ck.	碜
ck;	砗
ckb	礤
ckg	盛
ckgf	厕
ckgh	殂
ckh	残
ckh,	辰
cki	磁
ckih	磋
ckj	厝
ckl	唇
ckla	蹙
ckm	存
ckmg	础
ckx	碴
ckz	厨
cl	吃
cl,	叱
cl.	啜
cla	呲
clas	踔
clb	躇
cld	吵
clg	喘
clga	踹
clh	呈
clhk	踌
cli	蹭
clig	噌
clih	蹉
clij	蹲
clj	嘲
cljg	嗔
cljn	嘈
clk	蹰
clm	嗤
clo	蹿
clo,	嚓
clp	逞
clq	踟
clr	踩
cls	唱
clsj	嘬
clt	吹
clv	哧
clx	喳
cly	啐
clyl	蹴
clyw	躔
cm	出
cm,	承
cm;	陈
cmf	除
cmg	蚩
cmh	丑
cmq	陲
cmz	丞
cn	层
cni	羼
cnm	弛
cnm;	孱
cnp	迟
cnr	尺
co	察
co,	怊
co.	惨
co;	穿
co;a	惭
cof	怆
cofw	惝
cog	窜
cogf	恻
cogj	忡
coj	忖
cojr	怵
cok	宠
cokh	宸
cop	忱
coq	怅
coqx	忏
cot	惆
cow	窗
cox	憷
coy	悴
coyi	憧
cp	初
cp.	衩
cpe	褫
cpf	谶
cpi	禅
cpj	衬
cpja	谌
cpjk	褚
cpk	诚
cpl	裎
cpn	词
cpnl	祠
cpo	诧
cps	昶
cpt	谄
cptg	谗
cq	长
cq.	篡
cq.l	笞
cqa	垂
cqe	篪
cqf	矬
cqfr	罉
cqg	重
cqgj	种
cqh	筹
cqj	策
cql	程
cqlq	秤
cqp	愁
cqq	掣
cqq;	毳
cqs	乘
cqt	称
cqtv	稠
cqw	氚
cqy	辞
cqy,	簇
cr	采
cre	彩
crg	岔
crgr	汆
crj	豺
crs	刹
crt	鬯
cs	昌
csk	晨
csk/	晟
csr	晁
cst	匙
ct	处
ct;	舛
cte	匆
ctf	雏
ctg	触
cth	猜
ctn	刍
ctq	饬
cts	猖
ctss	鲳
ctt	册
cttg	馋
cttp	鸱
ctx	馇
cty	猝
cu	持
cu.	掺
cu/	闯
cua	扯
cub	搽
cud	抄
cue	拆
cuea	搋
cuf	撑
cuff	挫
cug	抽
cuga	揣
cugh	抻
cugx	摧
cui	阐
cuih	搓
cuj	措
cul	操
cuo	擦
cuo,	撺
cuq	插
cuqa	捶
cus	撮
cuss	阊
cut	搀
cuy	撤
cuy/	搐
cv	场
cv,	超
cve	坼
cvf	趁
cvk	城
cvl	埕
cvn	墀
cvt	坻
cvw	赤
cw	川
cw,	囱
cwk	臭
cwx	爨
cwy	魑
cx	查
cx.	橙
cx.v	杈柽
cx/	椽
cxf	椎
cxff	枞
cxh	椿
cxhk	楱
cxi	槎
cxj	村
cxjc	材
cxjk	楮
cxjn	槽
cxk	橱
cxl	樗
cxm	楚
cxo	檫
cxq	杵
cxq.	枨
cxqa	棰
cxw	槌
cxx	楂
cxxm	郴
cxy	榇
cxyg	榱
cy	次
cy.	充
cy.;	瘳
cy;	瓷
cya	疵
cyf	疮
cyff	痤
cyg	冲
cygh	廛
cyh	凑
cyhj	瘛
cyi	产
cyih	瘥
cyj	卒
cyk	颤
cyl	啻
cyq	痴
cyt	鹑
cyx	床
cyy	瘁
cz	错
cz.	钗
czd	钞
czf	锉
czft	铛
czg	锄
czj	豉
czjm	镡
czk	铖
czo	镩
czo,	镲
czq	锤
czqd	锸
czw	钏
czy	铲
czy.	铳
d	的
d,	刀
d,i	娣
d,p	妒
d,s	妲
d,y	嫡
d.	对
d.f	翟
d.g	叠
d.m	邓
d.p	怠
d.po	怼
d.pv	迨
d.t	凳
d.z	登
d/	缔
d/.	骀
d/.l	绐
d/i	绨
d/k	驮
d/q	缍
d/w	缎
d;	到
d;d	东
d;j	甙
d;k	顿
d;l	趸
d;t	鸫
da	点
dag	督
db	荡
dbo	菪
dbq	董
dbt	荻
dbtw	萏
dbv	芏
dbw	蔸
dby	蒂
dc	淡
dc;	沌
dcg	洞
dcj	渎
dcjg	滇
dco	淀
dcq	沲
dct	涤
dctk	澹
dcy	渡
dcyi	滴
dd	胆
dd;	胨
ddg	胴
ddo	腚
ddv	肚
de	得
dej	德
dejg	盾
deo	舵
dep	遁
deq	瓞
dev	待
df	但
df;	代
df;v	倒
dfg	贷
dfgi	黛
dfgj	佃
dfgx	岱
dfgz	侗
dfh	傣
dfj	仃
dfl	党
dfn	当
dft	低
dftk	儋
dfy	袋
dg	赌
dg.	瞪
dg.e	嶝
dg;	盹
dg;d	岽
dgg	峒
dggs	髑
dgh	电
dghk	帱
dgi	睇
dgii	赕
dgj	盯町
dgj.	黩
dgja	蝶
dgjg	巅
dgjk	睹
dgm	凼
dgn	鼎
dgo	蚪
dgp	迪
dgpt	眈
dgr	典
dgs	沓
dgt	骶
dh	动
dh/	毒
dha	玷
dhf	玳
dhg	纛
dhj	玎
dho	焘
dhon	靛
di	道
di;	炖
die	断
dij	灯
dik	奠
dil	兑
dim	郸
din	弟
dip	递
dit	羝
diw	煅
dj	丁
dj;	耋
djg	带
djga	聃
djgj	戴
djgt	觌
djj	酊耵
djk	顶
djkg	颠
djkl	蠹
djko	鞑
djm	都
djp	耽
djs	靼
dk	大
dk,	砀
dk.	歹
dk.e	磴
dk.l	殆
dk;	砘
dkf	碓
dkg	碘
dkgz	硐
dki	殚
dkj	夺
dkja	碟耷
dkl	石
dko	碇
dkp	达
dkt	碉
dkt;	砥
dky	礅
dkyi	碲
dl	吨
dl,	叨
dl.	蹬
dl.e	噔
dlb	嗒
dlg	吊
dli	啖
dlj	叮
dlja	蹀
dljk	嘟
dlk	呔
dlko	哒
dlm	咄
dln	叼
dlo	啶
dlq	跌
dlr	蹈
dlrr	嗲
dlt	跺
dlti	哆
dlto	咚
dltx	哚
dlv	哋
dly	踱
dlyi	嘀
dlyw	踮
dm	队
dma	阽
dmg	蛋
dmv	堕
dmva	陡
dn	刁
dni	弹
dnj	导
dnp	逮
dnt	殿
do	定
do,	忉
doa	悼
dob	懂
dog	恫
doi	惮
doj	斗
doj.	窦
dok	惰
dokl	宕
dos	怛
doy	惦
dp	调
dp.	裰
dp.l	诒
dpb	褡
dpf	裆
dpfr	谠
dph	祷
dpj	订
dpj.	读
dpja	谍
dpt	诋
dpw	诞
dpy	谛
dq	等
dq.	丢
dq.e	簦
dq/	笃
dqf	答
dqg	笛
dqi	氮
dqig	箪
dqij	簖
dqj	犊
dqjm	簟
dqn	第
dqp	迭
dqq	敌
dqr	稻
dqs	笪
dqt	氡
dqw	氘
dqwn	篼
dqz	短
dr	爹
dr,	貂
dri	籴
ds	旦
ds;	戥
dt	多
dt;	氐
dtf	雕
dtg	独
dtgj	甸
dtgx	岛
dti	狄
dtj	鲽
dtm	邸
dto	冬
dtp	鸟
dts	剁
dtt	鲷
dtx	朵
dty	丹
du	打
du.	掇
dua	掉
dub	搭
duf	挡
dui	掸
duj	揲
duo	抖
duon	掟
dus	担
dusj	提
dut	抵
dutp	捣
duv	垫
duy	掂
dv	地
dv;	垤
dva	坫
dvb	塔
dvf	堆
dvg	垌
dvj	堵
dvja	堞
dvn	埭
dvs	堤
dvt	垛
dvy	墩
dw	段
dwj	牒
dwj.	牍
dwt	兜
dwtx	躲
dx	杜
dx;	栋
dxf	档
dxj	椟
dxn	棣
dxo	柁
dxt	柢
dxw	椴
dy	度
dy;	冻
dya	店
dyb	瘩
dyg	帝
dyga	端
dygs	盗
dyi	瘅
dyj	疔
dyjg	癫
dyn	癜
dyp	憝
dyq	敦
dys	疸
dyt	底
dytv	凋
dyz	痘
dz	逗
dz.	铎
dz.e	镫
dz;	钝
dzg	钿
dzj	钉
dzl	豆
dzlg	铞
dzo	锭
dzoj	钭
dzq	铤
dzqa	铥
dzr	铫
dzs	锝
dzt	钓
dzw	锻
dzy	镀
dzyi	镝
dzyl	镦
e	而
e,	娥
e,m	婀
e;	轭
e;h	贰
eb	萼
ebg	蒽
ebk	苊
ebq	莪
ec	洱
ed	腭
ef	俄
efj	佴
eg	恩
egq	峨
egqa	蛾
eh	二
ehj	珥
ej	恶
eja	耳
ejl	噩
ejv	垩
ek	厄
ekk	奀
ekt	鸸
el	嗯
elj	唔
elk	颚
elk/	呃
elm	鄂
elq	哦
elt	鹗
en	屙
eo	额
eol	愕
ep	讹
ep.	诶
epl	谔
eq	鹅
es	遏
et	儿
etd	尔
etj	饵
etk	鲕
etl	鳄
etp	迩
etq	饿
eu	扼
eug	摁
ez	锷
ezj	铒
ezq	锇
f	分
f,	发
f,n	妇
f,nb	妃
f,v	飞
f,y	妨
f/	缝
f/a	绯
f/f	驸
f/j	缚
f/k	绂
f/n	绋
f/r	纷
f/y	纺
f;	辅
f;a	匪
f;z	辐
fa	非
fa.	翡
fag	蜚
fam	酆
fay	斐
fb	范
fba	菲
fbc	藩
fbd	菔
fbf	苻
fbfk	茯
fbh	芙
fbj	芾
fbq	蘩
fbr	芬
fbri	莩
fbv	葑
fby	芳
fc	法
fcd	淝
fch	沣
fci	瀵
fcn	沸
fcr	泛
fcr,	汾
fcri	浮
fcrr	滏
fcy	涪
fd	服
fda	腓
fdh	肤
fdj	肺
fdjn	脯
fdm	肥
fdq	腹
fdy	肪
fdyc	腑
fe	反
fep	返
fey	舫
ff	份
ff;	伐
ffh	俸
ffj	付
ffjb	偾
ffjn	傅
ffk	伏
ffn	佛
ffr	俘
ffv	垡
ffy	仿
ffyc	俯
fg	峰
fge	贩
fge.	畈
fgh	赋
fghr	蚨
fgj	赙
fgk	罘
fgp	罚
fgq	蝮
fgr	幡
fgri	蜉
fgs	幞
fgt	蜂
fgtv	帆
fgz	幅
fgzl	蝠
fh	夫
fhh	奉
fhhr	麸
fhj	丰
fhv	珐
fi	烦
fij	粪
fir	粉
firq	燔
fit	烽
fj	覆
fjn	甫
fjq	敷
fjr	酚
fk	否
fkg	奋
fkn	砩
fkt	矾
fktr	砜
fkv	砝
fl	咐
fla	啡
flah	霏
flf	跗
flh	呋
flhk	唪
flhr	趺
flk	吠
flr	吩
flrq	蹯
fm	防
fmf	附
fn	费
fn,	弗
fnt	艴
fo	富
foa	悱
foj	愤
fon	怫
fp	访
fpa	诽
fpah	扉
fpf	讣
fpfk	袱
fpk	祓
fpt	讽
fpy	房
fpz	福
fq	复
fq/	繁
fq;	篚
fqf	符
fqf;	筏
fqj	缶
fqn	氟
fqq	馥
fqr	氛
fqri	稃
fr	翻
fr.	乏
fre	斧
frg	番
frh	釜
frm	郛
frmz	孚
frp	忿
frr	父
fs	黼
fsk	黻
ft	风
ft.	凤
ft/	犯
fta	鲱
fte	饭
ftf	鲋
ftg	负
ftj	鲼
ftm	孵
ftn	狒
ftp	逢
ftq	鳆
ftt	凫
ftv	凡
fty	鲂
ftz	匐
fu	扶
fuf	阀
fufj	拊
fuh	抚
fun	拂
fv	封
fvf	赴
fvy	坟
fvy,	坊
fw	阜
fwr	鼢
fx	枫
fx;	榧
fxi	焚
fxk	樊
fxr	桴
fxr,	棼
fxt	梵
fxy	枋
fy	方
fy,	废
fy/	冯
fya	痱
fyf	府
fyg	腐
fym	邡
fyq	放
fyt	疯
fz	副
fzn	镄
fzt	锋
fztv	钒
fzy	钫
g	个
g,	姑
g,;	戤
g,d	尕
g,h	媾
g,i	妫
g,s	旮
g,z	哿
g.	观
g.f	矜
g.h	癸
g.k	颈
g/	给
g/f	纶
g/fn	缑
g/g	贯
g/gr	纲
g/j	红
g/ja	绀
g/jn	绠
g/q	纥
g/s	绲
g/y	缟
g;	戈
g;,	轨
g;;	匦
g;b	轧
g;j	轱
g;s	辊
gb	葛
gb,	菇
gbf	芥
gbj	苷
gbm	菰
gbn	茛
gbo	莞
gbt	苟
gbtp	鹳
gbx	藁
gc	沟
gcb	灌
gcf	淦
gcg	汩
gcj	港
gcja	泔
gcjl	沽
gcl	涡
gcn	溉
gcns	澉
gco	涫
gcy	滚
gd	归
gde	胍
gdf	胱
gdh	肝
gdj	肛
gdjz	臌
gdk	肱
gdku	尜
gdt	股
gdtv	胳
gdz	膈
ge	瓜
gez	舸
gf	光
gf,	伽
gfj	供
gfjl	估
gfk	颌
gfl	合
gfo	倌
gfq	仡
gfs	刽
gft	鸽
gftl	佝
gfw	傀
gg	国
gga	甴
ggd	骨
ggf	蛤
ggg	贵
gggh	蝈帼蜾
gggj	崮
gggr	岗
gggs	蛊
ggh	果
ggj	固
ggjj	罡
ggjl	蛄罟
ggq	虼
ggr	冈
ggr.	蚣
ggs	刚刿
ggt	购
ggtl	岣
ggtp	鹘
ggtv	骼
ggy	赅
ggyl	崞
gh	干
ghg	规
ghgt	觏
ghh	耕
ghj	珙
ghp	遘
ghw	瑰
gi	关
gig	盖
gii	糕
giih	羹
gin	炔
gio	羔
giz	馘
gj	过
gj,	功
gj;	丐
gja	甘
gjd	恭
gjg	革
gjgf	贡
gjgh	瞽
gjgr	汞
gjh	酐
gjhs	鞲
gji	耿
gjj	鼓
gjjl	酤
gjl	古
gjn	更
gjna	嘏
gjq	故
gjqb	乾
gjqr	攻
gjqx	聒
gjr	共
gjt	巩
gjt.	毂彀
gjtp	鸪
gjy	辜
gjz	工
gk	感
gkf	尬
gkh	矸
gkj	龚
gkk	顾
gks	尴
gkt	硌
gkv	硅
gky	磙
gl	跟
gl,	咖
glb	噶
gle	呱
glf	咣
glg	呙
glgh	呷
glj	咕
glja	咁
gljn	哽
glk	嘎
gln	哏
gln;	嘅
glns	噉
glq	夹
gls	剐
glt	跪
gltn	喼
gltv	咯
glv	啩
glz	嗝
gm	隔
gme	孤
gmy	陔
gn	改
gn;	艮
gnb	弓
gnq	敢
go	官
go,	宄
go.	怪
go/	惯
gok	寡
gol	宫
gos	割
gp	该
gpe	诟
gpf	雇
gph	冠
gpj	诂
gpq	诰
gpt	诡
gptv	袼
gpv	褂
gpvv	诖
gq	管
gqa	乖
gqb	罐
gqf	搿
gqh	竿
gqhs	篝
gqhx	秆
gqj	缸
gqjl	牯
gqjn	筻
gql	告
gqm	郜
gqn	簋
gqq	牿
gqs	刮
gqt	鸹
gqtl	笱
gqu	箍
gqy	稿
gqyl	篙
gr	公
gra	虢
grl	谷
gs	杲
gsh	旰
gsi	炅
gst	晷
gt	各
gt.	勾
gte	觚
gtf	觥
gtg	龟
gtgh	猓
gtgj	鲴
gtgs	鳏
gtj	鲠
gtk	鳜
gto	馆
gtp	逛
gtt	够
gtt.	鲧
gttl	狗
gtv	鲑
gty	犷
gu	搞
gu/	掼
gug	掴
guj	拱
gujs	擀
gujz	扛
gul	拐
gun	撖
guq	括
gut	阁
guu	搁
guv	挂
guvv	闺
gv	赶
gve	垢
gvf	卦
gvj	埂
gvja	坩
gvl	埚
gvq	圪
gvv	圭
gvy	垓
gvz	塥
gw	鬼
gwe	皈
gwg	盥
gwk	皋
gwn	躬
gwv	睾
gx	根
gx;	柜
gxf	桧
gxfq	桄
gxh	杆
gxj	梗
gxja	柑
gxjz	杠
gxn	概
gxns	橄
gxo	棺
gxq	梏
gxqx	栝
gxs	棍
gxt	格
gxt.	构
gxtl	枸
gxv	桂
gxw	槔
gxy	槁
gxyl	椁
gy	高
gy.	衮
gyc	广
gyg	裹
gygj	痼
gyj	疳
gyj.	庋
gyl	膏
gym	郭
gyn	庚
gynk	赓
gyp	戆
gyq	疙
gyt	赣
gz	哥
gzb	钆
gzg	钢
gzgj	锢
gzj	钙
gzjl	钴
gzl	锅
gzq	锆
gzs	亘
gzt	歌
gzt.	钩
gztv	铬
gzy	镐
gzz	镉
h	和
h,	好
h,g	贺
h,t	婚
h.	欢
h.;	戏
h/	缓
h/b	幻
h/e	绗
h/f	绘
h/ft	骅
h/g	缋
h/gs	缳
h/y	骇
h;	或
h;.	轰
h;n	互
h;r	轷
h;s	划
ha	虎
hav	壑
hb	花
hb,	薅
hb/	荭
hb;	荤
hbc	菏
hbe	蘅
hbf	荷
hbfh	荟
hbfy	萑
hbg	茴
hbj	葫
hbjh	蕻
hbjn	蕙
hbk	薨
hbl	藿
hbm	菡
hbs	劐
hbt	获
hby	荒
hbyl	蒿
hc	活
hc.	汉
hc;	汇
hca	滹
hcf	淮
hcfh	浍
hcg	滑
hcgj	涸漶
hcgk	溷
hcgl	洄
hch	汗
hcj	湖
hcja	洪潢
hcjk	鸿
hcjs	瀚
hcm	涵
hcn	泓
hco	浣
hcp	浑
hcpk	沪
hcpq	浒
hcq	海
hcqa	浩
hcs	混
hcsy	灏
hct	涣
hcw	湟
hcy	濠
hcyt	沆
hcz	河
hczs	洹
hd	胲
he	后
he/	後
heg	徽
hegl	徊
heh	行
hen	很
hep	逅
het	衡
hew	徨
hey	航
hf	会
hf,	化
hfg	候
hfgf	货
hfgs	盒
hfi	伙
hfj	华
hfk	颔
hfl	含
hfn	侯
hfp	辉
hft	係
hfz	何
hg	回
hgb	蠖
hge	骺
hgg	蛔
hggs	圜
hgj	虹
hgja	蚶蟥
hgjl	蝴岵
hgjn	蟪
hgjv	虾
hgk	贿
hgo	黑
hgp	患
hgq	蚝
hgs	幌
hgt	夥
hgte	囫
hgw	蝗
hgy	骸
hgz	蚵
hh	环
hha	琥
hhe	珩
hhf	耠
hhj	瑚
hhja	璜
hhk	顸
hhkl	砉
hhm	邗
hhn	彗
hhp	慧
hhp;	珲
hhq	耗
hhw	魂
hi	火
hif	烩
hifn	糇
hifp	焓
hij	糊
hija	烘
hijl	煳
hik	豢
hir	烀
his	焊
hit	焕
hiw	煌
hj	黄
hjd	胡
hjdt	鹕
hjf	翰
hjg	鬟
hjh	韩
hjj	醐
hjja	酣
hjk	卉
hjkl	醢
hjm	邯
hjn	画
hjnb	巷
hjp	惠
hjs	壶
hjt	觳
hk	还
hke	瓠
hkg	虺
hki	灰
hkj	磺
hks	厚
hl	号
hl/	喙
hla	唬
hlb	嗬
hlby	嚆
hlc	嗨
hlf	哈
hlf,	哗
hlfn	喉
hlfy	霍
hlg	嘿
hlgd	哕
hlgh	踝
hlj	哄
hljv	吓
hlk	喊
hlki	咴
hll	嚯
hlm	吼
hlr	呼
hls	喝
hlt	唤
hlte	唿
hlw	嗥
hly	哼
hly,	咳
hlyl	嚎
hlyt	吭
hm	孩
hmf	隳
hmm	函
hmw	隍
hn	弧
hn.	弘
hnp	憨
ho	害
hob	慌
hof	恍
hog	寰
hoh	寒
hoj	宦
hoja	黉
hojl	怙
hok	怀
hok.	宏
hoki	恢
hokz	憾
hon	恨
hop	逭
hoq	悔
hor	豁
hos	悍
hot	惚
hotg	鲎
how	惶
hoz	恒
hp	话
hpb	谎
hph	罕
hphm	讳
hpj	讧
hpjl	祜
hpk	户
hpki	诙
hpl	祸
hplm	扈
hpo	戽
hpp	诨
hpq	诲
hps	褐
hpt	鹤
hpz	诃
hq	禾
hqf	篌
hqg	秽
hqj	簧
hqt	鹄
hqte	笏
hqw	篁
hqy	氦
hr	乎
hrt	貉
hs	晃
hsf	晗
hsh	旱
hshr	昊
hsk	颢
hsp	晖
hsq	晦
hst	曷
ht	忽
htb	獾
htbf	鹱
hte	狐
htf	猴
htg	猾
htgk	奂
htj	猢
htm	郇
htn	狠
hto	斛
hton	鲩
hts	昏
hts;	馄
htw	凰
htwn	鳇
hty	訇
hu	换
hug	擐
huk	撼
huk.	闳
hul	攉
hup	护
hup;	挥
hus	捍
hut	阍
huv	阖
huy	阂
hv	坏
hvf	堠
hvg	盍
hvm	郝
hvp	恚
hvv	赫
hvy	壕
hw	皇
hwh	鼾
hwp	遑
hwq	皓
hwt	毁
hx	核
hxe	桁
hxf	桦
hxj	横
hxt	槲
hxw	槐
hxy	杭
hxz	桓
hy	毫
hy,	劾
hy,c	亥
hy;	冱
hyd	肓
hyf	瘊
hyj	癀
hyk	豪
hykg	颃
hyl	亨
hyn	痕
hyq	麾
hyt	痪
hz	惑
hz.	翮
hzb	镬
hzf	铧
hzfz	铪
hzi	钬
hzr	锾
hzt	锪
i	有
j	就
j,	九
j,/	驾
j,;	婕
j,f	妗
j,g	姐
j,h	奸
j,ha	婧
j,j	姬
j,j.	妓
j,l	加
j,ld	娟
j,o	嫁
j,p	迦
j,q	娇
j,t	鸠
j,v	及
j,x	架
j,y	姣
j,yr	嫉
j,yt	袈
j.	鸡
j.,	劲
j.n	艰
j.p	迳
j.s	刭
j/	经
j/,	级
j/.	骏
j/a	骥
j/g	畿
j/h	绩
j/i	继
j/i;	缣
j/j	结
j/jf	缙
j/jn	缰
j/k	缄
j/l	绢
j/lj	缉
j/m	纠
j/n	纪
j/q	骄
j/t	绝
j/tl	驹
j/ty	绛
j/w	缴
j/y	绞
j;	较
j;;	巨
j;e	匠
j;k	戒
j;l	辑
j;q	轿
j;w	皆
ja	韭
jab	乩
jag	冀
jagh	龃
jap	遽
jb	节
jb,	艽
jb,l	茄
jb,v	芨
jb.	茎
jb;	苣
jbc	茳
jbf	蕉
jbg	菌
jbgh	苴
jbgj	茧
jbh	藉
jbha	菁
jbi	蒹
jbj	芰
jbk	荐
jbki	蕨
jbl	荚
jblj	蕺
jbll	莒
jbn	荩
jbna	葭
jbo	菅
jbq	敬
jbs	荆
jbt	菊
jbtg	蓟
jby	蒋
jbyh	警
jbyr	蒺茭
jc	江
jc,	汲
jc.	浚
jc.j	泾
jc;	渐
jc;q	浇
jcg	溅
jcgh	沮
jch	浅
jci	湔
jcj	酒
jcjz	洁
jcl	涓
jclq	浃
jcn	津
jcnl	浸
jcp	滘
jcq	湫
jct	洚
jcu	涧
jcw	激
jcwn	洎
jcy	济
jd	脚
jd.	胫
jdg	胛
jdh	肼
jdha	腈
jdk	尖
jdn	腱
jdt	肌
jdy	胶
je	近
je.	径
jeg	舰
jej	斤
jev	街
jew	徼
jf	件
jf,	隽
jf.	仅
jf.r	俊
jf;	侥
jf;t	僭
jfb	儆
jff	价
jffl	俭
jffy	僬
jfg	俱
jfh	金
jfi	倦
jfj	借
jfj.	伎
jfjn	僵
jfjz	佶
jfn	假
jfnh	健
jfnq	倨
jfnt	倔
jfo	焦
jfp	今
jfq	牮
jfs	剑
jfst	偈
jft	鹪
jfv	佳
jfw	介
jfx	集
jfy	佼
jfyl	僦
jg	见
jg,	岌
jg.	矍
jg.r	峻
jg;	睫
jgf	界
jgfl	睑
jgfw	蚧骱
jgfy	雎
jgg	岬
jggt	觊
jgh	甲
jgh,	贱
jgha	睛
jghz	且
jgi	圈
jgj	羁
jgk	畸
jgl	蛱
jgm	囝
jgn	崛
jgnr	赆
jgp	迥
jgq	峤
jgr	具
jgt	虮
jgx	巾
jgy	嵴
jgyr	蛟
jh	进
jh,	戋
jh,l	珈
jhg	击
jhgt	靓
jhh	珏
jhhs	耩
jhj	瑾
jhn	琚
jhp	恝
jht	玑
jhtn	静
jhtv	玖
jhw	井
ji	精
ji,	剪
ji,z	姜
ji.	翦
ji/	卷
ji;	兼
ji;;	炬
jig	眷
jigl	炯
jigs	蠲
jij	粳
jin	烬
jinb	糨
jio	煎
jir	爝
jis	羯
jit	鹣
jix	桊
jj	教
jj,	嘉
jj.	柬
jj;	戟
jj;r	戬
jja	醵
jjb	鞯
jje	靳
jjf	截
jjfy	醮
jjg	贾
jjgf	赍
jjgh	堇
jjgt	觐
jjj	酵
jjjl	兢
jjjm	棘
jjjz	髻
jjk	颉
jjl	吉
jjm	鄄
jjq	救
jjqd	鬏
jjs	晋
jjt	鞠
jjty	鞫
jjv	基墼
jjw	聚
jk	奇
jk;	戛
jkf	礁
jkfl	硷
jki	厥
jkj	礓
jkk	碱
jkm	殛
jkn	厩
jkq	歼
jks	劂剞
jkst	碣
jkt	矶
jkx	丌
jl	叫
jl,	跏
jl;	距
jl;t	喈
jla	噱
jlf	噍
jlg	咀
jlh	践
jlhw	趼
jli	嗟
jlj	咭
jlja	戢
jlk	颊
jlki	蹶噘
jlm	郏
jln	踞
jln.	跽
jln;	唧
jlnh	踺
jlq	啾
jlr	嚼
jlt	叽
jltp	鹃
jlw	踽
jlx	噤
jly	跤
jlyr	霁跻哜
jm	际
jm/	卺
jmf	阶
jmh	阱
jmt	降
jmv	孓
jmz	孑
jn	即
jn.	建
jn.j	弪
jn;	既
jnb	己
jnbl	局
jne	屐
jnef	屦
jng	届
jnj	居
jnjn	疆
jnl	君
jnlg	强
jnm	郡
jno	尽
jnp	忌
jnq	犟
jns	剧
jnsz	暨
jo	家
jo,	究
joa	寂
jog	觉
jogh	惧
joh	举
johs	蹇謇
joi	窭
jok	寄
jon	窘
joq	悸
joqa	窖
jos	憬
jos.	悭
joy	惊
jp	军
jp,	皲
jp.	谲
jp;	讵
jpd	肩
jpf	衿
jpfz	袷
jpg	扃
jph	讲
jphw	诫
jphx	讦
jpi	谫
jpj	计
jpj.	谏
jpja	谨
jpjz	诘
jpn	记
jpnq	裾
jpnr	诀
jpt	讥
jpu	裥
jpx	襟
jq	积
jq,	笈
jq,l	笳
jq;	矩
jqd	筋
jqg	犋
jqgj	稷
jqgt	笕
jqh	籍
jqh,	笺
jqhw	笄
jqi	箭
jqj	箕
jqjz	秸
jqk	稽
jqk.	嵇
jqky	犄
jqm	季
jqn	毽
jqo	稼
jqq	矫
jqu	简
jqv	筠
jqx	榘
jr	爵
js	紧
jsf	鉴
jsg	监
jss	晶
jsv	坚
jsy	景
jt	几
jt,	解
jtd	系
jtg	狙
jtgh	飓
jth	祭
jth,	饯
jti	灸
jtj	馑
jtjz	鲒
jtk	獗
jtl	句咎
jtld	狷
jtn	鲫
jtnr	觖
jtp	急
jts	鲣
jtt	饥
jtth	角
jtv	久
jtx	桀
jty	狡
jtyi	獍
jtyl	鲸
jtyr	饺鲛鲚
ju	间
ju;	拒
ju;,	拣
ju;h	捷
juf	捡
jug	攫
jui	搛
juj	技
jujz	拮
juk	撅
juky	掎
jul	捐
julq	挟
jun	据
junk	捃
junr	抉
junt	掘
juo	搅
juq	揪
juqr	挢
jus	揭
jut	拘
jutg	阄
juti	掬
juy	接
juyr	挤
jv	均
jv,	劫
jv,v	圾
jvg	趄
jvm	赳
jvy	境
jw	臼
jwg	舅
jwq	敫
jwy	皎
jx	机
jx,	极
jx,l	枷
jx.	橘
jx;	楷
jxa	椒
jxf	检
jxg	枧
jxh	禁
jxj	桔
jxja	槿
jxk	柩
jxki	橛
jxl	楫
jxn	楗
jxnq	椐
jxo	杰
jxoq	榉
jxs	旧
jxsq	槛
jxt	桷
jxw	桕
jxy	校
jy	将
jy,	痂
jy.	竣
jy.j	痉
jya	齑
jyd	脊
jyf	疥
jyg	浆
jygh	疽
jyh	靖
jyj	酱
jyja	廑
jyk	减
jykv	奖
jyl	京
jylt	竞
jym	郊疖
jyn	决
jyna	瘕
jyns	麂
jyp	迹
jyq	疾
jyqd	麇
jyqq	旌
jyr	交
jys	剂
jyst	竟竭
jyt	净
jytp	鹫
jytv	疚
jyx	桨
jyy	瘠
jz	键
jz;	钜
jzf	镌
jzg	钾
jzi	锩
jzj	豇
jzk	镢
jzl	铗
jzn	锯
jznt	锔
jzo	镓
jzt	钧
jzu	锏
jzw	锦
jzy	镜
jzyr	铰
k	可
k,	馗
k/	绔
k/g	骒
k/j	缂
k/y	纩
k;	轲
k;g	匮
k;h	匡
ka	卡
kad	肯
kan	龈
kb	苦
kb.	葵
kb;	蒈
kbg	蒉
kbm	芤
kbo	蔻
kbs	蒯
kbv	莰
kbz	苛
kc	渴
kcg	溃
kcv	溘
kd	胯
kda	胩
kdf	脍
kf	侃
kfa	佧
kff	侩
kfk	侉
kfk,	龛
kfm	郐
kfo	倥
kfy	伉
kg	困
kg.	睽
kgd	岿
kgg	髁
kgh	眶
kgj	骷
kgk	颗
kgkp	眍
kgkv	蝰
kgl	贶
kgn	瞰
kgo	髋
kgo,	崆
kgq	蝌
kgqx	蛞
kgs	剀
kgt	凯
kgv	瞌
kgz	岢
kh	开
khb	亏
khs	刊
khs;	琨
khz	珂
ki	炕
kij	烤
kiw	夔
kiy	糠
kj	克
kj,	勘
kj;	考
kj;r	戡
kjg	聩
kjk	髡
kjp	恐
kjq	酷
kjs	醌
kjt	壳
kjtf	款
kk	矿
kkg	盔
kkh	夸
kks	刳
kkt	砍
kkv	磕
kkvv	奎
kkw	夼
kl	口
kla	啃
klaj	咔
klf	哙
klg	喟
klh	哐
klk	哭
klkv	喹
klky	跨
klm	叩
klo	喀
klv	嗑
klvv	跬
km	孔
kmw	隗
kn	恳
kn,	尻
knv	垦
ko	快
kob	宽
kog	恺
kogh	窠
kogj	愦
kogx	悃
koh	窥
koht	寇
koj	空
kon	慨
kont	窟
koq	忾
koqa	喾
kot	客
kotv	恪
kow	愧
koy	慷
kp	课
kph	诓
kpn	裉
kpt	诳
kpy	裤
kq	看
kqa	靠
kqg	篑
kqgh	稞
kqh	筐
kqj	氪
kqo	科
kqo,	箜
kqog	筷
kqp	适
kqu	筘
kqy	犒
ks	昆
ks.	暌
ksy	旷
kt	狂
ktf	狯
ktg	馈
kts	鲲
ku	抗
ku.	揆
ku;	揩
kuc	阔
kug	捆
kugx	阃
kuj	拷
kuk	挎
kukp	抠
kul	扣
kun	阚
kuo	控
kuy	扩
kuyt	闶
kv	块
kvg	坤
kvgg	垲
kvj	堪
kvk	垮
kvn	堀
kvp	逵
kvt	坎
kvy	坑
kvyc	圹
kvz	坷
kw	魁
kx	棵
kxh	框
kxj	枯
kxjk	栲
kxz	柯
ky	库
kyk	颏
kyl	况
kym	邝
kyn	康
kys	刻
kyt	亢
kyy	廓
kyz	疴
kz	钪
kz;	锴
kzg	铠
kzgh	锞
kzj	铐
kzs	铿
kzs;	锟
kzu	锎
kzz	钶
l	了
l,	力
l,g	娌
l,gj	嫘
l,j	姥
l.	垒
l.;	戮
l.t	鹨
l/	络
l/;	练
l/g	骡
l/gj	蠡缧
l/i	缕
l/j	骊
l/k	缭
l/n	绿
l/p	驴
l/pv	邋
l/s	缆
l/t	骆
l/tp	骝
l/tu	绺
l/v	绫
l/y	缡
l;	连
l;a	轳
l;f	轮
l;i	辚
l;j	辆
l;t	轹
l;tv	辂
l;y	辘
la	虑
la,	虏
laf	龄
lag	卤
lak	颅
lan	卢
lat	鸬
lb	落
lb,	劳
lb,,	荔
lb.	蓼
lb;	莲
lbc	蒗
lbf	莅
lbfl	蔹
lbfp	苓
lbg	萝
lbi	蒌
lbk	茏
lbk,	苈
lbl	莱
lblm	蕾
lbp	芦
lbph	莨
lbq	莉
lbqd	藜
lbqj	荦
lbs	蓝
lbu	蔺
lbv	菱
lby	蓠
lc	流
lc;	涟
lca	滤
lcan	泸
lcb	涝
lcf	沦
lcfh	鎏
lcfl	潋
lcfp	泠
lcg	泪
lcgj	澧
lci	粱
lcj	溧
lcjn	濑
lck	沥
lck.	洌
lcko	潦
lcl	涞
lcla	潞
lcm	泐
lcn	漏
lcnj	渌
lcp	浪
lcs	滥
lct	洛
lctd	泺
lctp	溜
lcu	澜
lcx	梁
lcxx	淋漤
lcy	漉
lcyr	浏漓濂
lcys	滦
ld	劣
ld,	肋
lda	胪
ldd	朤
ldf	脸
ldi	膦
ldj	腊
ldk	胧
ldl	脶
ldq	脷
ldy	臁
le	律
lea	舻
lel	徕
lf	领
lf,	仂
lf.	翎
lf;	瓴
lff	伦
lffp	伶
lfg	俚
lfgf	赁
lfgh	倮
lfgj	儡
lfi	偻
lfj	俩
lfj.	俪
lfjk	佬
lfjm	傈
lfk	例
lfko	僚
lfl	侣
lfm	邻
lfp	令
lfq	敛
lfqd	俐
lft	仑
lg	罗
lg/	累
lgb	崂
lgf	岭
lgfp	囹蛉
lgft	囵
lgg	螺
lgh	里
lgi	嶙
lgij	髅蝼嵝瞵
lgj	蜡
lgjg	罱
lgk	瞭
lgk;	蛎
lgl	睐
lglq	崃
lgo	罹
lgp	逻
lgph	螂
lgq	蜊
lgt	略
lgtr	岚
lgtv	赂
lgy	詈
lgyr	蠊
lh	理
lh;	琏
lhb	耢
lhf	玲
lhi	耧
lhj	耒
lhk	珑
lhk,	嫠
lhkx	弄
lhl	璐
lhp	琅
lht	珞
lhx	琳
lhy	璃
lhy.	琉
li	类
li,	娄
li/	粼
li;	炼
lif	羚
lih	兰
lii	烂
lik	燎
lik;	粝
lio	料
lip	粮
lipk	炉
lipv	遴
lit	烙
litp	熘
liy	粒
lj	两
lj,	勒
lj.	醪
lj/	鬣
ljf	聆
ljg	醴
lji	联
ljm	郦
ljn	吏
ljp	逦
ljr	酹
ljs	剌
ljt	老
ljtg	赖
ljtp	鹂
ljtt	聊
ljtv	酪
ljx	栗
lk	历
lk,	励
lk,v	龙
lk;	厉
lkf	殓
lkg	厘
lki	磷
lkj	聋
lkk	磊
lkk;	砺
lkkl	砻
lkkp	奁
lkn	碌
lko	烈
lks	列
lkt	砾
lktp	鹩
lktv	尥
lkv	垄
lky	裂
lky.	硫
lkyi	砬
ll	来
ll,	另叻
ll/	躐
llb	唠
llbu	躏
llf	零
llfp	呤
llg	雷
llgf	赉
llgh	哩
llgs	啰囉
lli	喽
llj	喇
llja	嘞
llk	咙
llk,	雳呖
llk.	咧
llkg	喱
llko	嘹
lll	吕
llla	露
llm	酃
llp	踉
llph	啷
llpk	唳
llq	嚟
llt	路
lltd	跞
lltg	噜
lltp	鹭
llu	啦
llx	霖
llxx	啉
lm	陆
lmj	陋
lmk	陇
lmp	辽
lmt	隆
lmv	陵
ln	灵
lne	履
lnf	录
lni	屡
lnj	隶
lnp	逯
lo	愣
lo.	寥
lof	怜
log	帘
logh	悝
loj	懒
lok	寮
lom	窿
loo	〇
loq	牢
loy	懔
lp	论
lp;	裢
lpb	礼
lpd	朗
lpf	裣
lpg	裸
lph	良
lphj	诔
lpi	褛
lpk	戾
lpm	郎
lpn	禄
lps	褴
lpu	谰
lpx	冧
lpy	谅
lq	利
lqb	乱
lqf	黎
lqg	箩
lqgi	黧
lqi	篓
lqj	籁
lqjm	篥
lqk	笼
lql	稆
lqn	氯
lqp	稂
lqq	犁
lqs	篮
lqt	氇
lqx	梨
lqy	笠
lqyr	篱
lqyt	簏
ls	量
ls,	旯
lsg	览
lsq	临
lsy	晾
lt	留
lt;	鲢
lta	鲈
ltd	乐
ltf	雒
ltg	狸
ltgh	鲤
ltgj	鳢
ltgs	猡
lti	鳞
ltj	猎
ltj.	鲡
ltja	鳓
ltk	獠
ltm	卵
ltp	狼
ltpv	遛
ltq	猁
lts	鲁
ltt	馏
ltv	鲮
lu	拉
lua	掳
lub	捞
luf	抡
lufp	拎
lug	撂
lugj	摞
lugs	攞
lui	拦
luij	搂
luj	阑
luk	拢
luko	撩
lul	擂
lull	闾
lup	捩
luph	阆
lur	捋
lus	揽
lut	撸
luy	掠
lv	垃
lva	垆
lvc	墚
lvg	塄
lvk	垅
lvk,	坜
lvk.	趔
lvr	埒
lw	魉
lx	林
lx,	婪
lxa	栌
lxf	柃
lxg	楞
lxgs	椤
lxi	楼
lxih	栏
lxj	楝
lxjk	栳
lxk	栊
lxk,	枥
lxl	檑
lxm	李
lxn	棂
lxp	榔
lxs	榄
lxt	柳
lxtd	栎
lxtg	橹
lxtp	榴
lxu	榈
lxv	棱
lxy	麓
lxyg	檩
lxyl	椋
ly	率
ly,	娈
ly.	廖
ly;	疠
lyb	痨
lyd	膂
lydg	蠃
lydi	羸
lyf	冷
lyfh	銮
lyg	离
lygj	瘰
lygr	脔
lygx	峦
lyi	立
lyi;	廉
lyij	麟瘘
lyj	辣
lyjn	癞瘌
lyk	冽
lyk,	疬
lyl	吝
lylp	亮
lym	疗
lymt	癃
lymz	孪
lyn	鹿
lyp	恋
lyph	廊
lypk	庐
lyq	旅
lyqd	痢
lyqj	挛
lyqy	旒
lyr	六
lys	刘
lyt	瘤
lytp	鸾
lyu	斓
lyv	凌
lyx	栾
lyy	凉
lyyg	凛廪
lz	丽
lz;	链
lzb	铹
lzf	铃
lzg	锣
lzgh	锂
lzgj	镙
lzi	镂
lzj	铑
lzk	镣
lzl	铝
lzlg	鬲
lzlm	镭
lzlq	铼
lzm	钌
lzp	锒
lzr	锊
lzt	镏
lztg	镥
lzu	镧
lzy	镰
lzy.	锍
m	们
m,	妈
m,/	姆
m,b	嫫
m,d	妙
m,h	妹
m,j	媒
m,m	媚
m,t	娩
m,y	嬷
m.	矛
m.f	鍪
m.g	蟊
m.gh	瞀
m.gj	蝥
m.q	牟
m.y	买
m/	马
m/.	缪
m/d	糸
m/g	缈
m/k	缅
m/n	缗
m/s	缦
m/w	绵
m/y	母
m;	迈
m;,	劢
m;c	万
ma	芈
mb	蒙
mb,	募
mb.	茅
mb.y	荬
mb/	蓦
mb;	甍
mbc	茫
mbd	慕
mbg	苗
mbgh	苜瞢
mbgs	蔑
mbgx	幕
mbh	茉
mbk	茂
mbkg	颟
mbko	莽
mbn	苠
mbq	摹
mbq/	莓
mbr	藐
mbs	暮
mbsd	萌
mbsg	蔓
mbsk	莫墓
mbt	茆
mbtp	鹋
mbtv	茗
mby	芒
mbyc	蘑蘼
mc	没
mcb	满
mcbk	漭
mcbs	漠
mcg	渺
mch	沫
mcj	沔
mck	湎
mcl	渑
mcm	湄
mcn	泯
mcp	懑
mcps	溟
mcs	汨
mcsg	漫
mct	泖
mctg	浼
mcx	沐
md	膜
mdb	朦
mdi	脒
mdk	腼
mdp	脉
me	艋
meb	艨
mf	命
mf.	侔
mft	仫
mg	目
mg.	眸
mg.q	蛑
mg/	蚂
mgb	瞒
mgbg	瞄蠛
mgbj	螨
mgbk	蟒
mgbp	蠓
mgbs	蟆
mgd	眇
mgg	冒
mggh	帽
mggr	淼
mgi	眯
mgj	眄
mgk	默
mgm	嵋
mgmj	蜢
mgn	眠
mgnn	岷
mgp	瞑
mgps	螟
mgs	皿
mgsg	幔
mgt	冕
mgtt	峁
mgv	墨
mgvr	睦
mgy	虻
mh	末
mh/	玛
mha	麦
mhg	瑁
mhn	珉
mhq	玫
mhy	玟
mhyc	耱
mi	美
mij	米
mija	煤
mip	迷
miq	敉
mis	熳
miu	焖
mj	某
mj.	卖
mji	醚
mjq	髦
mjq/	酶
mjq;	耄
mjt	酩
mjtg	鞔
mk	面
mk/	码
mkb	硭
mkbp	礞
mkg	冇
mkt	殁
ml	吗
ml.	哞
ml/	骂
mlb	喵
mle	灭
mlg	黾
mlh	呒
mlha	唛
mli	咪
mlih	咩
mlk	踎
mlo	嘧
mlq	霉
mlr	霾
mlt	鸣
mly	嘛
mlyx	嚤
mm	眉
mm,	勐
mmg	孟
mmk	陌
mmt	鹛
mn	民
mnj	弭
mnp	愍
mnt	弥
mo	忙
mob	寞
mobg	懵
mog	密
mogj	蜜
mom	寐
mop	宓
mos	慢
mou	悯
mp	谋
mp.	谬
mpb	谟
mpi	谜
mpk	幂
mpn	袂
mpp	谧
mps	冥
mpsg	谩
mpt	祢
mq	每
mq.	毪
mq;	毛
mqd	秒
mqg	篾
mqh	秣
mqq	敏
mqq;	牦
mqqr	牧
mqt	鳘
mqv	牡
mqw	穆
mr	貌
mrb	貘
mrg	觅
mrk	貊
mrp	邈
ms	明
msg	盟
msgs	曼
msh	昧
msp	暝
mst	昴
mt	么
mt,	勉
mt/	犸
mtb	猫
mtbs	馍
mtg	免
mtgf	贸
mtl	名
mtm	卯
mtmj	猛
mtmk	猸
mtn	猕
mts	馒
mtsg	鳗
mu	门
mu/	拇
mub	摸
mubg	描
mug	闽
muh	抹
muk	搣
mun	抿
mup	闷
muu	扪
muy	闵
mv	埋
mv/	坶
mvs	墁
mw	魅
mx	木
mx/	杩
mxb	模
mxbp	檬
mxd	杪
mxm	楣
mxp	懋
mxq	梅
mxqr	枚
mxt	梦
mxw	棉
my	亩
my.	袤
my/	縻
mya	靡
myb	瘼
myg	庙
mygh	盲
mygj	蛮
myi	糜
myk	磨
mym	邙
myn	氓
myns	麋
myq	摩
myqq	旄
myt	麽
myw	魔
myx	麻
mz	铭
mzb	锚
mzbs	镆
mzg	钼
mzi	镁
mzm	锰
mzmk	镅
mzs	镘
mzt	铆
mzu	钔
n	你
n,	乃
n,,	奶努
n,.	奴
n,/	驽
n,g	鼐
n,gr	胬
n,j	嫩
n,m	妞
n,mz	孥
n,n	娜
n,nb	弩
n,ne	妮
n,p	娘
n,po	怒
n,z	女
n.	能
n.f	难
n/	乜
n/g	纳
n/m	纽
n;	匿
na	虐
nb	孽
nb,	艿
nb/	乸
nbj	蔫
nbk	萘
nbt	茑
nbw	蘖
nc	浓
nca	淖
ncn	泥
ncn.	溺
nco	泞
ncs	涅
nd	脑
ndg	肭
ndh	腻
ndj	腩
ndn	脲
ndp	脓
nf	您
nf.	傩
nfh	佞
nfn	伲
nfp	念
nfpo	恁
nfpt	侬
nfq	拿
nfw	倪
ng	内
ng,	男
ng,j	嬲
ng,z	囡
ng;	蛲
ngj	蝻
ngw	睨
nh	瑙
nh;	辇
nhk	耨
ni	逆
nia	粘
nil	糯
nj	南
nj.	聂
nja	廿
njk	颞
njl	囊
njo	聍
njp	酿
nk	耐
nk,	孬
nkh	奈
nkn	碾
nkp	恧
nkw	硇
nl	呢
nl,	呶
nla	啮
nlb	喏
nlf	唸
nlfz	噏嗱
nlg	呐
nlga	啱
nlj	蹑
nlja	嗫
nljg	喃
nljn	囔
nln	哪
nlo	咛
nlp	哝
nlw	霓
nm	陧
nmn	孻
nn	那
nng	尿
nnt	尼
no	宁
nog	甯
nol	懦
nom	忸
non	怩
noy	恼
np	农
npb	诺
npf	谂
npg	讷
npgr	衲
nq	年
nq,	氖
nqa	黏
nqj	牛
ns	暖
nsn	昵
nsy	曩
nt	袅
nt.	猱
nta	鲇
ntf	鲶
ntj	馕
ntm	狃
nto	狞
ntr	馁
ntw	猊
ntw;	鲵
nu	闹
nu.	拟
nu;	挠
nua	拈
nuf	捻
nuh	撵
nuj	攮
nuk	捺
num	扭
nun	挪
nun.	搦
nuo	拧
nus	捏
nut	撚
nv	赧
nvf	埝
nvn	坭
nvy	垴
nw	臬
nwm	衄
nx	楠
nxh	柰
nxo	柠
ny	凝
ny;	疟
nyq	旎
nz	钮
nz,	钕
nz;	铙
nzb	锘
nzf	镎
nzg	钠
nzj	镊
nzn	铌
nzw	镍
o	偶
o;	区
ob	藕
oc	沤
oh	耦
ok	欧
ok;	瓯
okt	殴
oktp	鸥
ol	噢
olk	呕
oln	喔
oo	怄
op	讴
p	平
p,	皮
p,g	娉
p,i	姘
p,j	嫖
p,k	颇
p,o	嫔
p,w	媲
p/	骗
p/;	纰
p/i	骈
p/j	缥
p/l	辔
p;	匹
pa	频
pa.	攴
paw	颦
pay	裴
pb	蓬
pb;	芘
pba	疋
pbc	萍
pbce	蒎
pbcj	蒲
pbj	莆
pbk	苤
pbl	苹
pbt	葡
pbw	葩
pby	菩
pc	派
pc,	婆
pc,.	泼
pcf	濮
pcg	淠
pci	泮
pcig	潎
pcj	漂
pcjm	沛
pcjn	浦溥
pcjz	澎
pcq	湃
pcr	潘
pcr,	湓
pct	泡
pcy	滂
pd	胖
pdd	朋
pddt	鹏
pdi	胼
pdj	膨
pdk	胚
pdr	脬
pdw	脾
pe	盘
pea	徘
pek	磐
pem	爬
pex	槃
pey	彷
pf	偏
pf;	仳
pfa	俳
pff	仆
pfg	俜
pfn	僻
pft	凭
pftj	佩
pg	帕
pg,	帔
pg;	毗
pg;t	蚍
pgi	畔
pgj	瞟
pgjm	螵
pgjn	圃
pgjz	蟛
pgr	盼
pgrq	蟠
pgv	罴
pgw	睥
pgwn	蜱
pgy	赔
pgyi	螃
ph	珀
ph;	琵
phm	琶
phs	璞
phy	耪
pi	判
pi;	瓶
pie	叛
pig	瞥
pis	普
piw	粕
pj	配
pje	彭
pje.	瓢
pjg	聘
pjh	票
pjs	剽
pjt	飘
pjw	鼙
pjy	醅
pk	破
pk;	砒
pkd	硼
pkf	丕
pki	碰
pkl	砰
pkm	邳
pkr	殍
pkt	匏
pl	品
plb	蹒
plc	霈
ple	哌
plj	喷
pljm	嘌
pljz	嘭
plk	呸
pln	霹
plnc	噼
plp	蹁
plr	趴
pls	噗
plsi	蹼
plt	跑
pltn	咆
plu	啪
plw	啤
pm	陪
pmk	爿
pmw	陴
pn	屁
pn,	劈
pn;	甓
pny	譬
po	怕
pol	怦
pp	评
pp.	翩
ppi	谱
ppih	袢
ppp	谝
ppt	袍
ppx	襻
pq	篇
pq;	笸
pqc	氕
pqi	氆
pqp	犏
pqt	牝
pqty	篷
pqu	筢
pr	贫
prg	盆
prm	鄱
prw	貔
pt	匍
ptl	鲆
ptp	逄
ptt	狍
pu	拼
pu,	披
pu,,	抛
pu.	拚
pu;	批
pua	排
puf	扑
puh	捧
pui	撇
pul	抨
pun	擗
puw	拍
puy	掊
pv	培
pv,	坡
pvd	堋
pvk	坯
pvl	坪
pvn	圮
pvw	埤
pw	片
pwc	乒
pwm	郫
pwp	迫
pwr	皤
pwv	乓
pww	牌
px	攀
px;	枇
pxd	棚
pxf	朴
pxl	枰
pxll	榀
pxm	杷
py	旁
py,	疲
pyk	庞
pykf	痞
pyl	烹
pyn	癖
pyq	旆
pys	剖
pyt	庀
pytn	庖疱
pyw	裒
pz	铺
pz,	铍
pz;	钷
pzf	钋
pzi	镨
pzl	叵
pzs	镤
pzy	锫
q	起
q,	嫱
q.	劝
q.p	逡
q.y	巯
q/	骑
q/g	缱
q/i	绻
q/j	骐
q/k	驱
q/ky	绮
q/l	缲
q/q	纤
q;	七
q;,	切
q;,z	妻
q;.	轻
q;.;	翘
q;f	辁
q;k	顷
q;v	堑
q;x	椠
qa	歧
qag	觑
qaw	龋
qay	虔
qb	芹
qb;	萋
qba	蘧
qbc	蕖
qbf	芩
qbfh	荃
qbg	苘
qbh	葜
qbi	蕲
qbj	蔷
qbj,	茜
qbja	萁
qbk	颧
qbl	葺
qbn	茕
qbnb	芑
qbnh	荨
qbq	芊
qbqj	擎
qbqr	荞
qbt	芡
qbt;	芪
qbx	檠
qby	荠
qc	清
qc;	沏
qcf	洽
qcg	泅
qch	潜
qchk	溱
qcj	淇
qcp	沁
qcq	汽
qcqb	汔
qcx	渠柒
qcxf	漆
qcy	泣
qd	腔
qdf	雀
qdt	肷
qdtl	朐
qdy	脐
qe	颀
qeg	衢
qep	愆
qf	全
qf.	俟
qf;	倾
qf;;	佢
qf;r	戗
qfa	企
qff	俏
qfh	倩
qfj	俅
qfl	佥
qfn	侵
qfq	仟
qfqr	侨
qfs	劁
qfy	禽
qfyt	衾
qg	曲
qg.	黢
qgb	虬
qgf	瞧
qgfc	峭
qgfp	黔
qgfy	瞿
qgfz	囚
qgg	蛆
qggh	蠼
qggj	蛐
qgh	蜻
qgha	圊
qghk	螓
qghw	岍
qgi	蜷
qgih	蜣
qgij	蝤
qgj	嵌
qgj.	岐
qgja	蜞
qgjy	赇
qgk	崎
qgko	畎
qgkp	岖
qgn	岂
qgnb	屺
qgo	髂
qgp	遣
qgq	氍
qgqb	盵
qgv	畦
qgw	蚯
qgy	黥
qgyr	蛴
qh	青
qha	璩
qhf	琴
qhj	球
qhja	琪
qhk	琦
qhkv	契
qhq	秦
qhqj	挈
qhw	亓
qhy	琼
qi	前
qi,	券
qi.	羟
qif	炝
qih	羌
qij	酋
qip	遒
qiq	拳
qit	歉
qiw	糗
qj	其
qj,	勤
qj,z	娶
qj.	取
qj/	綦
qj;	巧
qjb	醛
qjd	期
qjf	鞘
qjfh	銎
qjg	蛩
qji	鬈
qjk	磬
qjl	跫
qjm	邛
qjp	逑
qjpo	悫
qjq	罄
qjqr	鞒
qjs	耆
qjsj	覃
qjt	欺
qjti	麴
qjtp	鹊
qjy	求
qjyh	謦
qjyt	裘
qk	确
qk;	砌
qk;q	硗
qka	戚
qkc	磲
qkh	碛
qko	犬
qkq	牵
qkt	欹
ql	器
ql;	跷
qlf	呛
qlf/	跄
qlfy	噙
qlh	嗪
qlk	嘁
qlp	吣
qlr	蹊
qm	亟
qm;	戕
qmq	阡
qn	群
qnm	屈
qo	情
qo,	穷
qo.	悛
qo/	骞
qo;	窃
qof	悄
qofy	憔
qofz	恰
qoh	惬
qoi	慊
qoj	窍
qon	穹
qoq	搴
qoqd	愀
qov	怯
qoy	寝
qoyt	褰
qp	请
qp/	綮
qpe	祈
qpf	诠
qpfc	诮
qpfy	谯
qpg	谴
qpi	谦
qpj	祺
qpl	启
qpm	祁
qpmg	诎
qpn	裙
qpnb	襁
qpq	讫
qpqr	啟
qpt	祗
qpv	祛
qq	气
qq.	氢
qqb	乞
qqf	签
qqfh	筌
qqh	氰
qqha	箐
qqhi	箧
qqi	秋
qqj	筇
qqn	缺
qqnh	犍
qqp	迁
qqpo	憩
qqpv	迄
qqu	箝
qqw	乔
qqx	千
qr	郄
qs	晴
qt	欠
qt,	劬
qth	鲭
qtj	鳍
qtn	卿
qtq	鳅
qtt	犰
qttp	鸲
qu	抢
qu.	阕
quf	擒
qug	阒
qui	阙
qup	掮
quq	撬
quqx	扦
qut	掐
quz	揿
qv	去
qve	圻
qvj	墙
qvja	趣
qvm	却
qvt	趋
qw	泉
qw,	鼽
qwj	丘
qwk	躯
qwm	邱
qx	权
qxf	枪
qxfy	樵檎
qxg	桤
qxj	棋
qxj,	栖
qxji	樯
qxk	槭
qxn	杞
qxp	榷
qxq	桥
qxq;	橇
qxqd	楸
qy	亲
qy,	妾
qy,l	瘸
qy.	弃
qy;	凄
qya	敲
qyf	痊
qyg	癯
qyj	麒
qyk	庆
qyq	旗
qyw	齐
qz	钱
qzf	铨
qzfp	钤
qzh	锲
qzha	锖
qzj	钳
qzn	镪
qznl	锓
qzq	锹
qzqx	钎
qzt	铅
qztf	钦
qzy	锵
r	人
r,	如
r,;	娆
r,p	忍
r,q	妊
r,v	刃
r.	柔
r/	绕
r/,	纫
r/h	绒
r/k	缛
r;	软
r;,	轫
r;k	戎
ra	睿
rb	若
rb,	茹
rb;	荛
rbf	荏
rbg	芮
rbga	苒
rbj	茸
rbk	蓐
rbk,	蕤
rbl	薷
rbo	蓉
rbp	惹
rbpo	蕊
rbx	荣
rc	润
rc,	汝
rc,z	洳
rck	溽
rcl	濡
rco	溶
rcx	染
rd	朊
rde	肜
rf	任
rf,	仍
rf,v	仞
rfb	偌
rfh	仁
rfl	儒
rg	肉
rga	冉
rgb	嵘
rgbp	蝾
rgg	蚋
rgga	蚺
rgl	蠕
rh	瑞
rh,	韧
ri	熔
ri.	糅
rit	燃
rj	髯
rj.	鞣
rk	辱
rl	嚷
rl.	蹂
rlk	颥
rll	嚅
rm	阮
rml	孺
rn	弱
ro	容
rp	让
rpf	认
rpk	褥
rpl	襦
rpq	衽
rpt	冗
rpy	禳
rq	稔
rqa	壬
rqb	箬
rqy	穰
rr	入
rrb	乳
rs	日
rt	然
rt;	饶
rth	狨
rtq	饪
ru	热
ru,	扔
ru.	揉
ruh	闰
ruk	扰
ruy	攘
rv	壤
rx	榕
rx;	桡
rxg	枘
ry	瓤
rz	融
rz,	铷
rzi	锐
rzo	镕
s	是
s,	始
s,,	劭
s,.	姒
s,k	娠
s,l	孀
s,m	邵
s,o	婶
s,p	恕
s,q	姝
s,t	姗
s,tv	妁
s,w	嫂
s,y	嬗
s.	厶
s..	双
s.h	叁
s.k	颡
s.q	毵
s.v	圣
s.x	桑
s/	书
s/,	绍
s/.	骚
s/.m	纾
s//	缫
s/d	纱
s/f	绱
s/g	驶
s/gh	绅
s/gj	缌
s/gt	驷
s/i	缮
s/l	绳
s/o	缩
s/p	骟
s/r	绥
s/ri	绶
s/t	鸶
s/z	丝
s;	式
s;f	输
s;h	轼
sa	上
sa.	叔
sb	苏
sb,	苕
sba	苫
sbaj	菽
sbc	莎
sbg	薯
sbh	蒜
sbi	薮
sbi;	蒴
sbj	葚
sbjk	蓍
sbjn	蔌
sbm	萨
sbmj	蔬荪
sbr	荽
sbs	莳
sbt	芍
sbt.	芟
sbw	虱
sbx	菘
sby	蓑
sbyi	莘
sc	深
sc,	涩
sc,z	娑
sc.	渗
sca	涉
scaj	淑
scd	沙
scg	汕
scgh	濉
scgt	泗
sci	溯
scj	洒
scja	澌滠
scjn	漱涑
scjr	沭
scjz	澍
sck	泷
scn	涮
scnb	汜
sco	渖
scp	沈
scq	挲
scqd	潲
scs	湿
sct	鲨
scw	溲
scx	淞
scxx	潸
scy	裟
sd	少
sdf	腧
sdg	省
sdgh	胂
sdgj	腮
sdgx	帅
sdi	膳
sdj	师
sdl	臊
sdq	胜
sdr	脎
sdy	膻
se	所
sef	艄
seg	舢
sei	艏
sew	艘
sf	使
sf.	似
sf.m	舒
sfd	倏
sfds	俞
sfg	伸
sfgf	赏
sfgj	畲
sfgl	尚
sfh	舍
sfhd	佘
sfhz	仨
sfi	伞
sfig	僧
sfih	餸
sfj	什隼
sfja	耸
sfjm	僳
sfjz	仕
sfl	售
sfp	食
sfpo	怂
sfq	伤
sfq;	毹
sfr	俗
sft	歙
sfv	侍
sfw	傻
sg	水
sg.	睃
sgd	蛳
sgf	赊
sgfy	睢
sgh	申
sgi	蟮
sgj	署
sgj.	赎
sgk	史
sgkj	髓
sgo	蛇
sgp	思
sgq	睡
sgqs	嵊
sgr	瞬
sgt	兕
sgtv	岁
sgtg	蜀
sgtk	赡
sgtz	四
sgv	墅
sgvj	峙
sgvv	眭
sgw	瞍
sgw;	螋
sgx	山
sgxr	崧
sgy	嵩
sgy/	蟀
sh	三
sh/	素
shd	示
shf	琐
shg	耜
shj	寿
shp	瑟
sht	珊
si	数
si.	羧
si.k	糁
si;	烧
sid	朔
sig	兽
sii	燧
sik	首
sikl	炻
sil	善
sim	鄯
sip	送
sipk	煽
sipv	遂
sis	剡
sit	烁
siv	塑
six	槊
siy	熵
sj	十
sj,	丧
sj,v	甚
sj.	酸
sj/	索
sja	世
sje	斯
sjg	贳
sjgl	啬
sji	粟
sjj	酾
sjm	声
sjn	事
sjnh	肆
sjnx	束
sjp	速
sjq	散
sjqd	酥
sjr	术
sjz	士
sk	死
sk,	耍
sk,c	豕
sk.	磉
sk;	厍
skd	砂
skg	蜃
skgh	砷
ski	爽
skj	奢
skja	厮
skjg	殖
skk	硕
skp	戍
skq	殊
skq,	殇
sks	卅
sky	碎
sl	虽
sl.	嗓
sl.r	唆
sl.t	吮
sl/	咝
sla	嘘
sle	嘥
slf	啥
slfc	哨
slfw	唢
slg	呻
slh	嗉
sli	嗍
slj	嘶
slj,	哂
sljk	嗜
sljn	嗽
sljp	嗦
sln	唰
slnl	嗣
slo	噻
slq	噬
sls	嗮
slt	跚
slw	嗖
slx	霜
sly	霎
sly,	嗾
slyi	唼
sm	收
smd	孙
smh	祟
smi	隧
smk	随
smkj	隋
sml	陕
smy	疏
sn	属
snb	巳
snc	尸
sni	屎
snj	肃
snl	司
sns	刷
so	赛
so;	室
sof	宿
sog	审
soh	愫
soj	守
soja	慑
sojg	慎
sojn	悚
soo	实
sop	邃
sor	忪
sov	塞
sovj	恃
sox	宋
sp	说
sp.	扇
sp.g	诵
spe	诉
spec	衫
spf	谁
spg	神
spgj	谡
spgt	视
spgx	讪
sph	试
spi	谥
spl	识
spn	祀
spq	诜
spr	讼
spt	设
spv	社
spvj	诗
spy	谇
sq	生
sq.	私
sqd	筛
sqf	稍
sqfc	筲
sqff	黍
sqg	算
sqgh	眚
sqgj	甥
sqi	税
sqj	手
sqjf	筮
sqji	穑
sqjn	簌穗
sqjr	秫
sqk	失
sqkv	矢
sql	舌
sqn	笋
sqnl	笥
sqnm	矧
sqq	牲
sqqj	笙
sqs	剩
sqt	舐
sqtf	歃
sqw	升
sr	受
sr.	释
srh	弑
srj	杀
srk	颂
srt	舜
ss	时
ssd	肾
ssg	曙
ssj	晒
ssjk	暑
ssw	晌
ssy	竖
st	色
st,	鲺
st.	殳
st.r	狻
st.u	鳋
st;	氏
std	狮
stf	猞
stfp	飧
stg	蚀
stgj	鳃
sth	甩
sti	鳝
stj	馓
stjn	觫
stk	夙
stm	狲
stn	饲
sto	煞
ston	狩
stq	饰
stq,	觞
stqd	稣
sts	删
stsj	鲥
stv	勺
stw	馊
stw;	飕
su	拾
su,	势
su.	抒
su..	搡
su.u	搔
sua	摅
sue	折
suf	闪
sufc	捎
sufh	拴
suh	拭
sui	擞
sui;	搠
suj	摄
suja	撒撕
sul	损
sun	扫
sup	逝
supk	搧
sur	授
suw	搜
suy	摔
suyg	擅
suyh	誓
suz	闩
sv	寺
svg	螫
svn	埽
svq	赦
svs	埘
svw	垧
svw;	埏
svy	墒
sw	身
sw.	叟
sw.p	鼠
swj	射
swk	顺
sx	松
sx.	树
sx.r	梭
sxc	桫
sxe	杉
sxf	梢
sxfh	栓
sxfy	榫
sxj	椹
sxk	枢
sxp	述
sxt	栅
sxx	森
sxy	梳
sxyg	柿
sy	市
sy,	孰
sy,l	韶
sy.	瘙
syc	痧
syg	商
sygh	衰
sygx	疝
syj	庶
syjn	竦
syn	麝
syo	熟
syq	施
syt	飒
syv	塾
syw	瘦
syx	凇
sz	锁
sze	钐
szg	锶
szr	铩
szt	铯
sztd	铄
szw	锼
szy	铈
t	他
t,	她
t,g	帑
t,p	迢
t,y	婷
t.	通
t.i	炱
t.l	台
t.m	邰
t/	统
t/k	彖
t/o	驼
t/s	缇
t/t	绦
t;	屯
t;p	忒
ta	凸
ta,	龆
tap	忐
tb	萄
tb.	苔
tb;	薹
tb;;	荑
tbd	藤
tbf	荼
tbg	茼
tbgr	氹
tbgs	萜
tbq	莛
tbt	菟
tby	葶
tc	涛
tc,	汤
tc.	滩
tcf	涂
tcfw	淌
tcg	湍
tcgj	漯
tch	添
tci	烫
tcin	涕
tcj	汀
tcjm	潭
tck	汰
tco	沱
tcr	滔
tcr;	洮
tcs	溻
tct	淘
tcy	溏
tcyi	潼
td	脱
td.	胎
tde	腯
tdf	膛
tdg	腆
tdi	腾
tdih	滕
tdk	肽
tdk,	豚
tdn	腿
te	徒
teq	艇
tf	体
tff	偷
tffr	傥
tfg	贪
tfgr	氽
tfj	仝
tfl	堂
tflx	棠
tfo	佗
tfp	途
tfr	佻
tft	倜
tfto	佟
tfy	停
tfyi	僮
tg	团
tg;	囤
tga	贴
tgal	帖
tgf	螳
tgi	蜕
tgj	田
tgk	炭
tgq	蜓
tgqr	畋
tgr	眺
tgt	图
tgt.	骰
tgtv	蜩
tgy	瞳
tgyi	疃
tgyt	螗
tgz	同
th	天
thd	忝
thf	泰
thfw	耥
thl	吞
thr	韬
ths	替
thy	瑭
ti	糖
ti.	烃
tig	羰
tim	郯
tin	煺
tis	剃
tit	鹈
tiy	誊
tj	忑
tj,	髫
tjf	酴
tjg	酮
tjk	酞
tjkl	橐
tjo	酡
tjs	醍
tjy	醣
tk	太
tka	套
tkf	餮
tkfe	殄
tkfj	砼
tkg	碳
tkj	厅
tko	砣
tkp	态
tl	听
tl,	趿
tl.	叹
tl.g	嗵
tl.l	跆
tlf	饕
tlg	踏
tlgj	鼍
tlj	嚏
tlo	跎
tlq	唾
tlqa	霆
tlr	跳
tls	踢
tls.	蹋
tlt	啕
tlv	吐
tly	啼
tlyi	蹄
tm	陶
tmi	粜
tmo	陀
tn	退
tnd	臀
tnj	屠
tnja	屉
to	它
toh	恸
toi	悌
tok	头
toko	突
toq	恬
tor	窕
tos	惕
tp	谈
tpj	讨
tpjm	谭
tpn	褪
tpr	祧
tps	袒
tpst	裼
tq	特
tq,	笤
tq.	廷
tqb	乇
tqg	筒
tqh	舔
tqi	毯
tqj	甜
tqk	颓
tqp	透
tqt	秃
tqu	箨
tr	逃
tr,	妥
trj	鼗
ts	题
tsh	昙
tsp	遢
tss	剔
tsy	暾
tt	条
tt,	饧
tt.	鲐
tt;	饨
tte	彤
ttg	兔
ttj	獭
tto	鸵
ttp	逖
tts	鳎
ttt	鲦
tu	投
tu.	抬
tu.f	摊
tu.g	捅
tuf	推
tuh	抟
tuhr	掭
tuj	阗
tuk	拓
tuko	挞闼
tup	探
tuq	托
tuqa	挺
tuqm	拖
tur	挑
tut	掏
tuy	搪
tv	土
tvf	趟
tvh	坛
tvj	填
tvo	坨
tvs	坦
tvs.	塌
tvt	坍
tvtg	堍
tvy	塘
tw	躺
tx	桶
txe	柝
txf	樘
txg	桐
txi	梯
txm	椭
txq	梃
txr	桃
txs	榻
txy	檀
ty	痛
ty.	瘫
tyg	童
tyi	痰
tyj	亭
tyja	庹
tyn	唐
tyq	庭
tyt	疼
tz	铁
tz;	铽
tzc	铴
tzf	镗
tzg	铜
tzi	锑
tzii	锬
tzk	钛
tzo	铊
tzp	慝
tzs	钽
tzv	钍
u,	放
u.	难
u/	呀
u;	倒
ua	则
ub	吧
uc	重
ud	第
ue	很
uf	化
ug	由
uh	于
ui	首
uj	及
uk	科
ul	里
um	母
un	建
uo	头
up	排
uq	区
ur	认
us	四
ut	同
uu	角
uv	种
uw	我
ux	系
uy	以
uz	总
v	这
w	为
w,	娃
w,h	妩
w,l	娲
w,n	娓
w,o	婉
w,v	丸
w.	鹜
w.,	婺
w./	骛
w/	维
w/,	纨
w/h	纬
w/k	毋
w/o	绾
w/y	纹
w;	瓦
w;g	辋
wa	龌
wb	薇
wb,	芄
wbh	苇
wbht	芜
wbk	葳
wbl	莴
wbn	蔚
wbo	菀
wbq	萎
wbr	蓊
wbt	芴
wby	蕹
wc	温
wc/	潍
wcf	鋈
wcg	渭
wcgh	涠
wch	污
wcha	汪
wci	沩
wcj	浯
wck	洧
wcn	渥
wcq	沃
wcv	洼
wcy	湾
wcyr	汶
wd	腕
wdh	肟
wdo	脘
wds	腽
we	往
weg	微
wen	艉
wf	位
wf;	佤
wfg	偎
wfh	伟
wfi	伪
wfj	伍
wfq	侮
wfqd	倭
wfqj	仵
wg	围
wg;	畏
wgd	胃
wgf	帷
wgh	帏
wgi	罔
wgk	崴
wgl	蜗
wglh	蜈
wgn	幄
wgo	蜿
wgo,	畹
wgp	遗
wgq	巍
wgr	网
wgv	蛙
wgw	嵬
wgy	蚊
wgz	囗
wh	无
wha	王
whaa	武
whd	未
whh	玩
whhm	玮
whk	顽
whm	韦
who	琬
whp	违
wht	鹉
wi	烷
wig	煨
wih	炜
wij	焐
wj	五
wjf	卧
wjff	巫
wjfo	斡
wjl	吾軎
wk	威
wk,	戊
wkb	兀
wkj	歪
wko	碗
wkq	硪
wl	味
wlb	嚄
wlf	唯
wlg	喂
wlh	吴
wlr	嗡
wlt	雾
wlte	吻
wltn	呜
wlv	哇
wly	雯
wm	卫
wmg	隈
wmk	阢
wn	尾
wn;	屋
wnj	尉
wnp	慰
wo	完
wof	惟
wog	惘
woh	怃
woj	悟
wol	窝
wom	寤
woo	惋
woq	忤
wos	剜
wot	宛
wp	误
wpg	谓
wph	袜
wpj	诬
wpq	诿
wq	我
wq,	委
wqj	午
wqjn	牾
wqp	逶
wqpv	迕
wqt	物
wqtn	稳
wqty	舞
wqw	魏
wr	翁
wr;	瓮
ws	晚
wsh	旺
wshm	韪
wsj	晤
wt	外
wt,	务
wt/	危
wte	勿
wtg	猥
wtgj	猬
wtk	鲔
wtm	邬
wtn	乌
wts	刎
wu	问
wuh	闱
wuj	闻
wujn	捂
wujo	挝
wun	握
wuo	挖
wur	阌
wus	揾
wut	挽
wv	圩
wvh	圬
wvt	坞
ww	皖
wwg	魍
wwh	璺
wwj	鼯
wx	枉
wxj	梧
wxk	杌
wxt	桅
wy	文
wy,	妄
wy/	紊
wyb	亡
wyf	於
wyh	望
wyht	庑
wyj	痦
wyn	弯
wyp	忘
wyq	痿
wys	瘟
wz	豌
wzt	钨
x	学
x,	姓
x,/	絮
x,g	勰
x,i	嫌
x,j	嬉
x,m	婿
x,s	旭
x,u	娴
x,w	媳
x.	习
x.o	熊
x/	线
x/;	骁
x/c	乡
x/f	绡
x/fp	飨
x/g	细
x/j	续
x/ja	绁
x/jk	绪
x/jz	缬
x/p	巡
x/q	绣
x/t	绚
x/w	驯
x/x	缃
x/y	骧
x;	邪
x;g	匣
x;h	轩
x;o	辖
xa	些
xas	虚
xb	芯
xb/	芗
xbe	荇
xbes	蓰
xbf	莶
xbg	苋
xbgj	葸
xbgr	荥
xbj	蕈
xbk	薤
xbn	萧
xbnb	芎
xbo	萱
xbob	蓿
xbq	薰
xbt	荀
xbtg	藓
xbw	薛
xbx	葙
xbxe	菥
xby	蓄
xbyi	薪
xc	消
xca	瀣
xcb	潇
xcf	溆
xcj	泄
xcja	渫
xcn	汛
xcnh	浔
xco	渲
xcp	泻
xcq	洗
xcr	淆
xcri	溪
xcrk	浠
xcrm	汹
xct	汐
xcts	洵
xcw	涎
xcwm	洫
xcwn	溴
xcx	湘
xcxe	淅
xcy	漩
xcy/	泫
xd	小
xd,	胁
xds	腥
xdt	胸
xdw	腺
xdx	膝
xe	须
xea	徙
xee	循
xef	徐
xej	舾
xet	欣
xets	徇
xey	舷
xez	衔
xf	修
xf.	叙
xf.;	翕
xf;	偕
xfd	肖
xff	鑫
xfg	仙
xfgs	儇
xfj	僖
xfl	侠
xfo	斜
xfp	逍
xfs	削
xft	像
xftp	鸺
xfx	休
xfy	信
xg	县
xg,	勖
xgf	蛸
xgg	岘
xggj	岫
xggt	蚬
xgh	盱
xgj	黠
xgl	峡
xgo	瞎
xgp	悬
xgr	崤
xgrq	蟋
xgs	蝎
xgt	峋
xgtg	蟓
xgw	螅
xgx	蜥
xgy	眩
xh	现
xhe	形
xhk	顼
xhm	邢
xhn	瑕
xhs	刑
xhv	型
xhy	璇
xi	炫
xi.	翔
xig	籼
xij	粞
xim	羞
ximk	糈
xio	煊
xiq	羲
xir	烯
xit	鲞
xiw	熄
xiy	羡
xiz	烜
xj	下
xj,	协
xj,b	西
xjf	靴
xjfx	髹
xjg	觋
xji	喜
xjk	项
xjko	献
xjm	孝
xjmk	醑
xjo	熙
xjoo	熹
xjq	馨
xjqa	酰
xjqg	醺
xjr	酗
xjs	昔
xjsq	醒
xjv	鞋
xjy	醯
xk	雄
xk;	戌
xkf	硝
xkg	夏
xkh	硎
xki	燹
xkj	硒
xkk	厦
xkl	硖
xko	碹
xkt	殉
xktv	矽
xkx	厢
xky	袭
xkz	咸
xl	需
xl,	吸勋
xl;	哓
xlf	霄
xlft	喺
xlfx	咻
xlh	吁
xli	躞
xlj	嘻
xlja	霰
xljk	哮
xln	雪
xlna	霞
xlnj	啸
xlo	喧
xlq	跹
xlqa	跣
xlr	唏
xlt	兄
xlw	响
xlwn	嗅
xm	限
xm.	陉
xmd	胥
xmdv	隙
xmf	险
xmp	逊
xms	隰
xmt	陷
xn	屑
xne	屣
xnf	犀
xnj	寻
xnja	巽
xnp	迅
xnpv	遐
xny	弦
xo	性
xoe	忻
xof	宵
xog	泶
xoj	惜
xoq	兴
xoqa	宪
xor	穴
xos	惺
xot	懈
xots	恂
xotv	穸
xov	悻
xow	恤
xoy	窨
xoz	宣
xp	心
xp.	诩
xp;	写
xp;t	谐
xpa	谑
xpg	袖
xpgs	禤
xph	祆
xphj	禊
xpi	详
xpih	祥
xpj	禧
xpn	讯
xpq	许
xpr	谖
xpt	询
xpw	谢
xpwx	训
xq	先
xq,	秀
xqa	罅
xqf	筱
xqg	氙
xqj	牺
xqm	卸
xqn	箫
xqo	熏
xqp	选
xqq	笑
xqqa	筅
xqr	稀
xqs	香
xqx	箱
xr	凶
xr/	奚
xr;	兮
xrf	貅
xrk	希
xrm	郗
xrp	悉
xrt	欷
xs	显
xs;	晓
xse	昕
xsg	贤
xsi	曦
xsn	暇
xso	煦
xson	暄
xsp	暹
xsq	星
xsqg	曛
xst	歇
xsx	晰
xt	象
xtf	猃
xtg	蟹
xtgh	狎
xth	玺
xti	鲜
xtih	馐
xtl	狭
xtlm	鳕
xtn	鲟
xtp	邂
xtq	饩
xtqg	獯
xtr	匈
xts	旬
xtsq	猩
xtt	馅
xttt	獬
xtv	夕
xtw	饷
xtx	枭
xu	闲
xue	掀
xuf	携
xuj	撷
xul	踅
xuo	揎
xut	鹇
xuw	擤
xuw;	阋
xv	幸
xva	墟
xvl	埙
xw	向
xw,	囟
xwf	魈
xwi	衅
xwm	血
xwp	息
xwr	鼷
xwt	舄
xx	想
xx.	栩
xx;	朽
xxe	析
xxg	相
xxgh	柙
xxh	械
xxhj	楔
xxl	杏
xxl;	枵
xxn	樨
xxnw	榍
xxo	楦
xxt	橡
xxw	榭
xxwn	皙檄
xy	新
xy.	燮
xy.m	序
xy/	玄
xyf	庥
xyg	畜
xygx	席
xyi	庠
xyj	辛
xyl	享
xyll	襄
xyq	效
xyqa	冼
xyqm	旋
xyt	癣
xytf	歆
xytt	廨
xyu	亵
xyub	痫
xyy	痃
xz	销
xze	锨
xzq	锈
xzqa	铣
xzs	锡
xzy	锌
xzy,	镟
xzy/	铉
xzyl	镶
y	一
y,	盈
y,.	妤
y,;	姨
y,g	姻
y,h	妍
y,j	嫣
y,jf	娅
y,k	妪
y,l	娱
y,m	孕
y,q	妖
y,r	姚
y,ri	媛
y.	又
y.,	勇
y..	羽
y.f	以
y.g	翼
y.gh	甬
y.k	预
y.kx	羿
y.m	予
y.p	恿
y.q	矣
y.t	允
y.tg	豫
y.tp	鹬
y.y	翌
y/	约
y/,	幼
y/.	驭
y/.h	绎驿
y//	缘
y/f	验
y/g	缨
y/h	纭
y/hx	纡
y/i	彝
y/ik	缢
y/l	邕
y/v	幺
y;	与
y;,	轺
y;;	夷
y;d	牙
y;f	雅
y;k	尧
y;p	迓
y;q	医
y;qk	轶
y;t	鸦
y;tf	欤
y;tp	鸢
y;v	弋
y;vl	辕
ya	虞
yag	卣
yaj	龉
yb	乙
yb.	苡
yb.m	蓣
yb/	药
yb/u	萦
yb/z	蕴
yb;	芽
ybb	艺
ybf	莜
ybfh	蓥
ybg	英
ybgj	萤
ybgk	茵
ybh	莹
ybh.	芸
ybht	芫
ybhx	芋
ybi	荧
ybl	营
ybm	荫
ybq	莠
ybt	莺
ybt;	茚
ybtp	苑
ybtq	莸
ybv	茔
ybw	萸
yby	薏
yby,	菸
yc	源
yc.	涌
yc/	胤
ycb	滢
ycbp	潆
ycc	渊
yce	沂
ycf	渝
ycfz	瀹
ycg	油
ycgk	泱洇
ych	沅
ychj	滟
yci	洋
ycih	漾
ycik	溢
ycj	湮
yck	淹
yckv	涯
yco	演
ycp	泳
ycr	浴
ycri	淫
yct	沿
yctg	渔
yctq	漪
ycy	游
ycy,	淤
ycyb	瀛
ycyf	液
yd	月
yd;	胰
ydg	胭
ydi	媵
ydj	腰
ydn	膶
yds	刖
ydw	腴
ydy	腋
ydy/	臃
ydyi	臆
ye	役
yec	衍
yei	徉
yeiv	舣
yej	衙
yeq	御
yer	徭
yet	殷
yf	余
yf.	耀
yf.g	俑
yf;	伢
yfb	亿
yfd	攸
yfg	觎
yfi	仪
yfih	佯
yfj	俨
yfk	优
yfkd	侑
yfkl	佑
yfkp	伛
yfky	倚
yfl	俣
yfn	伊
yfp	愈
yfpo	悠
yfpv	逾
yfq	佚
yfr	佾
yft	仰
yfth	佣
yfy	依
yfz	偃
yfzl	龠
yg	因
yg,	婴
yg.	野
yg.g	蛹
yg.h	峄
yg.l	贻眙
yg/	幽
yg/p	黝蚴
yg;	蚜
yg;d	岈
yg;z	屿
ygf	嵛
ygfz	蝓
ygg	蚰
ygh	园
yghb	曳
yghx	禺
ygi	蚁
ygih	蛘
ygj	由
ygjm	崾
ygjn	圄
ygk	央
ygkd	囿
ygkl	岩
ygku	崦罨
ygkv	崖睚
ygkw	螈
ygl	圆
yglg	蝇
ygm	邮
ygn	眼
ygnm	蚓
ygp	遇
ygpo	愚
ygq	罂
ygqb	屹
ygr	峪
ygs	蜴
ygt	鸭
ygti	黟
ygtp	鸯鹦
ygtq	嶷
ygv	圉
ygw	蜒
ygy	蝣
ygz	蜮
yh	远
yh.	云
yh;	琊
yha	玉
yhb	瑛
yhf	瑜
yhg	盂
yhgf	璎
yhh	耘
yhi	琰
yhl	鼋
yhp	运
yhpv	迂
yhr	瑶
yhr;	珧
yhri	瑗
yhs	韫
yht	元
yhtm	艳
yhx	于
yi	义
yi,	炀
yi.	熠
yif	烨
yig	益
yigk	烟
yih	羊
yii	炎
yiih	烊
yiii	焱
yik	猷
yip	恙
yis	煜
yit	焰
yiw	养
yiw.	燠
yix	丫
yj	要
yj,	酉
yj;	焉
yjf	亚
yjfc	严
yjg	鞅
yjh	酝
yjj	酽
yjk	颐
yjl	燕
yjm	耶鄢鄞
yjmb	酏
yjmv	雨
yjy	懿
yjz	壹
yk	友
yk.	尤
yk.;	翳
yk;	砑
ykb	尢
ykd	有
ykf	雁
ykfp	餍
ykg	页
ykgf	赝
ykgh	奄
ykgk	殃
ykgt	砚
ykh	研
ykj	硬
ykjl	殪
ykk	厌
ykkg	靥
ykko	厣
ykl	右
yklg	殒
ykm	郁
ykp	愿
ykv	压
ykw	原
ykwn	魇
yl	员
yl.	踊
yl/	哟
yl/p	呦
yl/v	吆
yl;	呀
yl;;	咦
ylb	呓
ylc	霪
ylf	吟
ylfn	咿
ylfz	喻
ylg	咽
ylgf	嘤
ylgh	喁嘢
ylh	雩
ylj	叶
yljf	哑
yljl	噎
ylk	喐
ylm	郢郧
ylm;	邑
yln	吲
ylp	咏
ylq	跃
yly	咬
yly.	唷
ylyh	唁
ylyi	噫喑
ym	也
ymd	阴
ymg	隅
yml	陨
ymo	院
yms	阳
ymt	隐
yn	已
ynh	聿
yni	熨
ynij	粥
ynk	尹
ynkx	异
ynx	引
ynz	鬻
yo	宜
yo.	怡
yo.h	怿
yo/	窈
yob	忆
yoe	窳
yof	愉
yofz	窬
yog	寓
yogk	怏
yoh	宇
yoi	悦
yoj	寅
yok	忧
yokd	宥
yokk	恹
yol	悒
yop	恽
yoq	窑
yos	宴
yosg	愠
yoy	誉
yoyt	慵
yp	议
yp,	永
yp.	译
yp;	讶
ypf	谕
ypj	语
ypjg	谳
ypm	郓
ypo	谊
ypq	诱
ypr	裕
ypri	谣
yps	谒
ypt	冤
ypts	诣
ypw	谀
ypy	谚
yq	移
yqg	秧
yqgk	氤
yqh	竽
yqi	氧
yqj	氩
yqo	箢
yqp	迤
yqr	夭
yqs	氲
yqw	筵
yqy	毓
yr	欲
yrg	釉
yrh	爰
yrk	肴
yrm	爷
yrp	遥
yrr	爻
yrs	刈
yrt	鹞
yrt.	繇
yrtp	鹆
yrw	舀
ys	曰
ys.	曜
ys;	晕
yse	影
ysf	晔
ysg	映
ysi	业
ysm	邺
yso	晏
yst	易
ysty	昀
ysy	昱
yt	用
yt.	疑
yt.l	饴
yt.t	狁
ytf	馀
ytfh	狳
ytg	鱼
ytgh	眢
ytk	犹
ytk.	鱿
ytkg	颖颍
ytky	猗
ytm	印
ytn	肄
yto	夤
ytp	迎
ytpk	狱
ytpo	怨
ytpv	逸
ytq	饫
ytr	鳐
ytt	饮
yttp	鸳
ytv	猿
yty	匀
ytyh	狺
ytyt	鳙
yu	摇
yu,	扬
yu/	掾
yu;	揠
yuf	揄
yug	押
yugf	撄
yuh	闫
yui	阅
yuj	揶
yuk	掩
yuku	阉
yul	揖
yulm	挹
yur	援
yut	拥
yutm	抑
yutw	阎
yuy	掖
yuy,	阏
yuz	阈
yv	越
yvg	盐
yvj	垭
yvjm	堙
yvk	塬
yvl	袁
yvn	垠
yvnb	圯
yvo	垸
yvs	埸
yvy	墉
yvz	域
yvzs	垣堰
yw	延
yw;	粤
yw;z	臾
ywg	岳
ywgj	鼬
ywk	舁
ywn	禹
ywp	邀
ywpk	牖
ywr	舆
yws	劓
ywso	鼹
yx	样
yx,	杨
yx,.	楹
yx/	橼
yxf	榆
yxg	樱
yxgj	柚
yxj	椰
yxjf	桠
yxk	椅
yxs	杳
yxt	檐
yxv	樾
yy	应
yy,	疡
yy.	冶
yy.;	翊
yy.t	兖
yy/	雍
yy;	痍
yyd	育
yyd,	嬴
yydg	赢
yye	彦
yyf	夜
yyff	膺
yyfp	饔
yyg	裔
yygf	瘿
yyh	言
yyi	痒
yyj	痖
yyk	颜
yyk.	疣
yykv	奕
yykx	弈
yyl	瘗
yym	瘾
yyn	庸
yyp	意
yyq	旖
yys	音
yyt	毅
yyt.	疫
yytc	衣
yyth	痈
yytp	鹰
yyty	韵
yyv	壅
yyw	亦
yyw;	庾瘐
yyy	瘀
yyyi	癔
yz	银
yz;	钺
yz;d	铘
yzb	钇
yzd	钥
yzg	铀
yzgk	铟
yzh	钰
yzi	镒
yzk	铕
yzm	郾
yzy	镛
yzyi	镱
yzyt	铱
z	在
z,	召
z,g	妯
z,j	杂
z,t	姊
z,y	嫜
z.	蚤
z/	组
z/.	缀
z//	缁
z/;	彘
z/f	纵
z/fy	骓
z/g	甾
z/gh	驵
z/i	缯
z/j	骤
z/jg	缜
z/jv	纣
z/l	织
z/o	综
z/on	绽
z/q	缵
z/t	终
z/t;	纸
z/tn	绉驺
z/w	缒
z/y	驻
z;	转
z;/	辎
z;;	轾
z;e	斩
z;f	轸
z;fh	錾
z;g	轴
z;gx	匝
z;h	臻
z;j	辄
z;l	轵
z;m	郅
z;n	辗
z;q	致
z;s	暂
z;v	至
z;y	辙
za	战
za/	紫
zaa	止
zaaa	龇
zag	贞
zagf	赀
zaj	卓
zak	砦
zal	占
zas	桌
zat	觜
zay	訾
zb	著
zb/	荮
zba	芷
zbc	藻
zbcg	菹
zbh	蓁
zbj	蘸
zbk	葬
zbm	蒸
zbmg	茁
zbo	苎
zbp	芝
zbq	茱
zbs	蕞
zby	蔗
zc	治
zc,	沼
zc.	泽
zc.;	濯
zc/	淄
zca	沾
zcag	浈
zcg	浊
zch	渍
zci	洲
zci;	滋
zcj	汁
zcja	湛
zcjk	渚
zcjs	滞
zck	涿
zcl	澡
zcla	浞
zcn	涨
zco	滓
zcq	洙
zct	潴
zcu	浙
zcx	渣
zcy	注
zcyi	漳
zd	脏
zdf	胗
zdg	肿
zdi	朕
zdj	肢
zdjv	肘
zdo	腙
zdo,	膣
zdq	胀
zdqa	胙
zdt	脂
zdt;	胝
ze	质
ze.	舟
ze/	卮
zef	爪
zeg	徵
zegj	舯舳
zej	征
zeq	舴
zf	作
zf;	侄
zfa	侦
zfas	倬
zff	众
zffv	坐
zfg	仲
zfgh	俎
zfh	债
zfj	做
zfjg	值
zfk	仗
zfkj	佐
zfl	掌
zfm	仔
zfo	伫
zfq	侏
zft	仉
zfte	偬
zfy	住
zg	中
zg,	助
zg;	崭
zg;v	蛭
zga	罪
zgaa	眦
zgag	帧
zgas	罩
zgd	胄
zgf	畛
zgg	崽
zggs	盅
zgh	贼
zgha	帻
zghx	曱
zgi	赠
zgi;	赚嵫
zgig	罾
zgj	置
zgk	赈
zgkg	颛
zgl	帜
zgn	瞩
zgo	贮
zgp	忠
zgq	账
zgq.	帐
zgqa	蚱
zgqj	蛛
zgqk	蜘帙
zgr	眨
zgs	则
zgt	睁
zgtk	瞻
zgtn	峥
zgy	赃
zgyi	蟑嶂幛
zgyj	蛀
zh	专
zhf	珍
zhg	责
zhgf	赘
zhgs	盏
zhh	奏
zhk	琢
zhm	耔
zhq	珠
zhqa	瓒
zhy	璋
zi	着
zi;	甑
zig	烛
zij	糟
zijv	尊
zil	燥
zim	郑
zimz	籽孳
zio	粽
zip	总
zipv	遵
ziq	炸
zit	灼
zitu	糌
ziu	州
ziv	灶
ziy	炷
zj	再
zj.	支
zj.;	翥
zj;	载
zj;.	甄
zja	髭
zjg	直
zjh	赜
zjj	正
zjjj	整
zjjv	酎
zjjz	喆
zjl	哉
zjlr	职
zjm	鄹
zjo	枣
zjoj	斟
zjon	鬃
zjoo	煮
zjp	志
zjpv	遭
zjq	政
zjr	真
zjs	者
zjt	酌
zjts	酯
zjx	栽
zjy	醉
zk	左
zka	砧
zke	斫
zkf	仄
zkh	砖
zkha	碡
zkj	砸
zkjn	臧
zkp	逐
zkq	砟
zkt	磔
zkv	丈
zl	只
zl;	啭
zla	足
zlaa	嘴趾
zle	踬
zlf	唑
zlg	躅
zlh	啧
zli	踯
zlj	吱
zlja	喋
zljk	啫
zljm	咂
zlk	震
zlk,	啄
zlkj	咗
zlkl	跖
zll	躁
zlll	噪
zln	嘱
zlo	踪
zlo,	咤
zlq	咋
zlqa	躜
zlqb	吒
zlqg	踵
zlt	咒
zltn	踭
zltv	啁
zlu	哳
zlw	咱
zlwn	唣
zly	嗻
zm	子
zm/	骘
zm;	阵
zma	陟
zmg	阻
zmj	陬
zmk	奘
zmq	孜
zmqa	阼
zmv	坠
zmy	障
zn	张
zng	帚
znj	展
znl	咫
zns	昼
zo	字
zo;	窒
zo;g	窀
zog	宙
zoga	惴
zoh	宗
zohs	寨
zoi	灾
zoig	憎
zoj	怔
zoj.	忮
zoq	窄
zoqa	怍
zoqb	宅
zoy	宰
zp	之
zp,	诏
zp.	褶
zp;	谮
zpa	祯
zpaa	祉
zpf	诊
zpg	祖
zpgh	诅
zpi	禚
zpj	证
zpja	诹
zpjk	诸
zpk	冢
zpk,	诼
zpl	祝
zpn	肇
zpq	诈
zpqa	祚
zpqj	诛
zpt	诌
zptk	谵
zptn	诤
zptp	鸩
zpy	谆
zpyi	谪
zpyt	谘
zq	制
zq/	纂
zq/k	篆
zq;	簪
zqa	乍
zqal	毡
zqe	笊
zqf	稚
zqfy	雉
zqg	赞
zqgh	租
zqh	竺
zqha	箦
zqj	朱
zqjg	稹
zqjk	筑箸
zqk	箴
zql	知
zqm	邾
zqp	造
zqpo	怎
zqpv	迮
zqq	竹
zqqa	笮
zqqk	秩
zqs	智
zqt	笫
zqtd	秭
zqtn	筝
zqu	籀
zr	兆
zri	豸
zs	最
zs,	昭
zsi	凿
zsig	黹
zsj	早
zsk	昃
zso	照
zsq	昨
zt	争
zt,	皱
zt/	鲻
ztg	螽
zti	炙
ztig	觯
ztij	鳟
ztj	猪
ztja	鲰
ztm	邹
ztn	馔
ztr	詹
zts	旨昝
ztt	狰
ztv	周
ztx	橥
ztxs	猹
zty	獐
zu	指
zu,	执
zu,l	招
zu.	择
zu.;	摺擢
zu/	絷
zu/,	拶
zu;	找
zub	扎
zue	抓
zug	闸
zugf	贽
zugh	拽
zugj	蛰蜇
zuh	揍
zui	掷
zuij	撙
zuk	振
zul	哲
zula	捉
zum	拙
zum,	拯
zun	撰
zunq	搌
zuq	挚
zuqa	攒
zuqi	攥
zut	挣
zutp	鸷
zux	揸
zuy	摘
zuyi	撞
zuyj	拄
zuyq	摭
zv	走
zva	址
zvi	增
zvj	赭
zvjg	埴
zvq	趱
zvr	赵
zvw	圳
zvy	趑
zw	自
zw;	皂
zwp	追
zwx	齄
zx	植
zx.	杼
zx;	桎
zxa	桢
zxas	棹
zxb	札
zxbm	栉
zxe	栀
zxh	栈
zxhk	榛
zxi	樽
zxj	枝
zxk	杖
zxkl	柘
zxl	枳
zxo	棕
zxo,	榨
zxp	枕
zxpj	槠
zxq	株
zxqa	柞
zxy	柱
zxyc	桩
zxyi	梓樟
zy	准
zy,	妆
zy,z	姿
zya	站
zye	彰
zyf	座
zyfe	疹
zyg	资
zygj	衷
zyi	粢
zyj	主
zyjj	症
zyjl	痣
zyjz	壮
zyk	状
zyk,	瘃
zykg	斋
zyl	咨
zym	鄣
zyn	麈
zyp	这
zypo	恣
zypv	遮
zyq	族
zyqa	痄
zyqt	旃
zys	章
zyt	鹧
zyto	瘵
zyv	庄
zyvj	痔
zyy	装
zyyi	瘴
zyyj	疰
zz	针
zz/	锱
zza	钻
zzf	锥
zzg	钟
zzgf	铡
zzgs	镯
zzh	铸
zzj	镇
zzjj	钲
zzjk	锗
zzl	锃
zzq	锺
zzqj	铢
zzs	钊
zzt	铮
zzy	镞
